sample,chromosome,start,end,strand,unique_reads,multi_reads,total_reads,junction_type,junction_id
sample_1_Aligned.sortedByCoord.out,chr6,5090597,5095736,+,10,0,10,known,chr6:5090597-5095736
sample_1_Aligned.sortedByCoord.out,chr7,9082054,9083685,-,7,1,8,known,chr7:9082054-9083685
sample_1_Aligned.sortedByCoord.out,chr1,29573330,29582339,+,14,1,15,known,chr1:29573330-29582339
sample_1_Aligned.sortedByCoord.out,chr18,46825503,46830547,+,11,2,13,known,chr18:46825503-46830547
sample_1_Aligned.sortedByCoord.out,chr5,18315145,18319243,+,14,0,14,known,chr5:18315145-18319243
sample_1_Aligned.sortedByCoord.out,chr18,11333854,11340062,+,13,2,15,known,chr18:11333854-11340062
sample_1_Aligned.sortedByCoord.out,chr1,19488400,19496861,-,13,1,14,known,chr1:19488400-19496861
sample_1_Aligned.sortedByCoord.out,chr9,48611532,48616855,-,15,4,19,novel,chr9:48611532-48616855
sample_1_Aligned.sortedByCoord.out,chr18,1405501,1407436,+,11,1,12,known,chr18:1405501-1407436
sample_1_Aligned.sortedByCoord.out,chr2,43480704,43482366,+,8,4,12,known,chr2:43480704-43482366
sample_1_Aligned.sortedByCoord.out,chr3,47003193,47009178,+,15,0,15,novel,chr3:47003193-47009178
sample_1_Aligned.sortedByCoord.out,chr7,38716284,38725597,+,10,6,16,known,chr7:38716284-38725597
sample_1_Aligned.sortedByCoord.out,chr15,46277482,46287320,+,14,2,16,known,chr15:46277482-46287320
sample_1_Aligned.sortedByCoord.out,chr8,47301522,47307824,+,11,4,15,known,chr8:47301522-47307824
sample_1_Aligned.sortedByCoord.out,chr6,19339816,19348233,-,8,0,8,known,chr6:19339816-19348233
sample_1_Aligned.sortedByCoord.out,chr2,27660313,27667409,+,11,0,11,known,chr2:27660313-27667409
sample_1_Aligned.sortedByCoord.out,chr15,34176403,34183088,-,13,3,16,known,chr15:34176403-34183088
sample_1_Aligned.sortedByCoord.out,chr19,41660533,41666836,-,11,3,14,novel,chr19:41660533-41666836
sample_1_Aligned.sortedByCoord.out,chr10,14863322,14863557,-,13,3,16,known,chr10:14863322-14863557
sample_1_Aligned.sortedByCoord.out,chr20,43410981,43415113,-,7,1,8,known,chr20:43410981-43415113
sample_1_Aligned.sortedByCoord.out,chr7,3270539,3275642,+,10,1,11,known,chr7:3270539-3275642
sample_1_Aligned.sortedByCoord.out,chr13,37176108,37178910,-,6,2,8,known,chr13:37176108-37178910
sample_1_Aligned.sortedByCoord.out,chr7,41970319,41974220,-,10,1,11,known,chr7:41970319-41974220
sample_1_Aligned.sortedByCoord.out,chr13,24855445,24860347,+,10,0,10,known,chr13:24855445-24860347
sample_1_Aligned.sortedByCoord.out,chr16,19864953,19867295,+,13,2,15,known,chr16:19864953-19867295
sample_1_Aligned.sortedByCoord.out,chr3,1612044,1618198,+,7,5,12,known,chr3:1612044-1618198
sample_1_Aligned.sortedByCoord.out,chr21,8492827,8500143,-,16,1,17,known,chr21:8492827-8500143
sample_1_Aligned.sortedByCoord.out,chr21,12879316,12880466,-,4,4,8,known,chr21:12879316-12880466
sample_1_Aligned.sortedByCoord.out,chr2,28609145,28610615,+,11,2,13,novel,chr2:28609145-28610615
sample_1_Aligned.sortedByCoord.out,chr19,44090599,44096879,-,13,1,14,known,chr19:44090599-44096879
sample_1_Aligned.sortedByCoord.out,chr12,1857198,1864971,-,9,1,10,known,chr12:1857198-1864971
sample_1_Aligned.sortedByCoord.out,chr10,5662001,5670738,+,11,6,17,known,chr10:5662001-5670738
sample_1_Aligned.sortedByCoord.out,chr19,1525802,1532919,-,10,3,13,known,chr19:1525802-1532919
sample_1_Aligned.sortedByCoord.out,chr15,9306459,9315019,+,11,0,11,known,chr15:9306459-9315019
sample_1_Aligned.sortedByCoord.out,chr18,46643239,46647521,-,10,3,13,known,chr18:46643239-46647521
sample_1_Aligned.sortedByCoord.out,chr16,38751832,38755246,+,10,2,12,known,chr16:38751832-38755246
sample_1_Aligned.sortedByCoord.out,chr22,17366312,17375201,+,9,1,10,novel,chr22:17366312-17375201
sample_1_Aligned.sortedByCoord.out,chr15,21718808,21727555,+,13,4,17,known,chr15:21718808-21727555
sample_1_Aligned.sortedByCoord.out,chr14,4449483,4454795,-,10,4,14,known,chr14:4449483-4454795
sample_1_Aligned.sortedByCoord.out,chr19,43630263,43635478,+,9,3,12,known,chr19:43630263-43635478
sample_1_Aligned.sortedByCoord.out,chr5,36249163,36252626,-,12,4,16,known,chr5:36249163-36252626
sample_1_Aligned.sortedByCoord.out,chr1,45335719,45341608,+,10,2,12,novel,chr1:45335719-45341608
sample_1_Aligned.sortedByCoord.out,chr16,29930831,29938061,-,13,4,17,known,chr16:29930831-29938061
sample_1_Aligned.sortedByCoord.out,chr1,21118512,21126233,-,8,2,10,known,chr1:21118512-21126233
sample_1_Aligned.sortedByCoord.out,chr18,37985400,37991927,+,14,1,15,known,chr18:37985400-37991927
sample_1_Aligned.sortedByCoord.out,chr10,7352304,7358995,-,13,1,14,known,chr10:7352304-7358995
sample_1_Aligned.sortedByCoord.out,chr6,45970278,45974267,+,12,1,13,known,chr6:45970278-45974267
sample_1_Aligned.sortedByCoord.out,chr15,24987773,24990146,+,15,2,17,known,chr15:24987773-24990146
sample_1_Aligned.sortedByCoord.out,chr17,26483363,26487814,-,11,5,16,known,chr17:26483363-26487814
sample_1_Aligned.sortedByCoord.out,chr1,37958434,37964822,+,8,3,11,known,chr1:37958434-37964822
sample_1_Aligned.sortedByCoord.out,chr14,13605539,13610811,+,13,0,13,known,chr14:13605539-13610811
sample_1_Aligned.sortedByCoord.out,chr12,44692867,44699469,-,7,6,13,known,chr12:44692867-44699469
sample_1_Aligned.sortedByCoord.out,chr19,7159701,7164568,+,11,1,12,known,chr19:7159701-7164568
sample_1_Aligned.sortedByCoord.out,chr22,14755150,14757013,+,10,0,10,known,chr22:14755150-14757013
sample_1_Aligned.sortedByCoord.out,chr8,10057410,10063707,+,9,2,11,novel,chr8:10057410-10063707
sample_1_Aligned.sortedByCoord.out,chr6,11857736,11858847,+,7,1,8,known,chr6:11857736-11858847
sample_1_Aligned.sortedByCoord.out,chr17,33091910,33097186,-,4,0,4,novel,chr17:33091910-33097186
sample_1_Aligned.sortedByCoord.out,chr7,1600461,1610297,-,17,2,19,known,chr7:1600461-1610297
sample_1_Aligned.sortedByCoord.out,chr11,3246206,3256178,-,12,2,14,known,chr11:3246206-3256178
sample_1_Aligned.sortedByCoord.out,chr4,46733626,46736878,+,11,1,12,known,chr4:46733626-46736878
sample_1_Aligned.sortedByCoord.out,chr8,16797395,16798642,-,10,4,14,known,chr8:16797395-16798642
sample_1_Aligned.sortedByCoord.out,chr14,32892056,32898525,-,7,0,7,known,chr14:32892056-32898525
sample_1_Aligned.sortedByCoord.out,chr13,40505737,40515696,+,13,2,15,known,chr13:40505737-40515696
sample_1_Aligned.sortedByCoord.out,chr3,47262273,47265840,-,9,6,15,known,chr3:47262273-47265840
sample_1_Aligned.sortedByCoord.out,chr5,22248995,22258514,+,10,2,12,known,chr5:22248995-22258514
sample_1_Aligned.sortedByCoord.out,chr18,25674528,25683377,+,7,3,10,known,chr18:25674528-25683377
sample_1_Aligned.sortedByCoord.out,chr2,45816462,45824764,+,16,3,19,known,chr2:45816462-45824764
sample_1_Aligned.sortedByCoord.out,chr20,18030412,18034902,-,10,2,12,known,chr20:18030412-18034902
sample_1_Aligned.sortedByCoord.out,chr11,23277021,23284001,-,9,4,13,known,chr11:23277021-23284001
sample_1_Aligned.sortedByCoord.out,chr2,46431181,46433932,-,12,1,13,novel,chr2:46431181-46433932
sample_1_Aligned.sortedByCoord.out,chr5,47712931,47718589,-,13,2,15,known,chr5:47712931-47718589
sample_1_Aligned.sortedByCoord.out,chr14,36215680,36219961,+,7,3,10,known,chr14:36215680-36219961
sample_1_Aligned.sortedByCoord.out,chr19,21290658,21293072,+,8,5,13,known,chr19:21290658-21293072
sample_1_Aligned.sortedByCoord.out,chr16,15551922,15554961,-,9,3,12,known,chr16:15551922-15554961
sample_1_Aligned.sortedByCoord.out,chr16,27441847,27445874,+,7,3,10,known,chr16:27441847-27445874
sample_1_Aligned.sortedByCoord.out,chr16,34000455,34004431,-,10,4,14,known,chr16:34000455-34004431
sample_1_Aligned.sortedByCoord.out,chr18,28739531,28748703,-,8,1,9,novel,chr18:28739531-28748703
sample_1_Aligned.sortedByCoord.out,chr14,17078124,17087763,-,8,5,13,known,chr14:17078124-17087763
sample_1_Aligned.sortedByCoord.out,chr7,36952741,36961409,-,10,0,10,novel,chr7:36952741-36961409
sample_1_Aligned.sortedByCoord.out,chr22,27539462,27548696,-,9,3,12,known,chr22:27539462-27548696
sample_1_Aligned.sortedByCoord.out,chr17,20040086,20041015,-,7,3,10,known,chr17:20040086-20041015
sample_1_Aligned.sortedByCoord.out,chr7,1533601,1542708,+,6,2,8,known,chr7:1533601-1542708
sample_1_Aligned.sortedByCoord.out,chr16,38275506,38276868,+,7,4,11,known,chr16:38275506-38276868
sample_1_Aligned.sortedByCoord.out,chr15,19467577,19475551,+,13,3,16,known,chr15:19467577-19475551
sample_1_Aligned.sortedByCoord.out,chr11,11812375,11820833,+,10,1,11,known,chr11:11812375-11820833
sample_1_Aligned.sortedByCoord.out,chr21,6427598,6435622,-,12,2,14,known,chr21:6427598-6435622
sample_1_Aligned.sortedByCoord.out,chr10,24787071,24791822,+,8,1,9,known,chr10:24787071-24791822
sample_1_Aligned.sortedByCoord.out,chr10,12205117,12205993,+,7,0,7,known,chr10:12205117-12205993
sample_1_Aligned.sortedByCoord.out,chr13,14059741,14067236,+,8,0,8,known,chr13:14059741-14067236
sample_1_Aligned.sortedByCoord.out,chr5,15247136,15255982,-,13,1,14,novel,chr5:15247136-15255982
sample_1_Aligned.sortedByCoord.out,chr9,23630283,23632478,+,3,4,7,novel,chr9:23630283-23632478
sample_1_Aligned.sortedByCoord.out,chr3,40857316,40861099,+,13,2,15,known,chr3:40857316-40861099
sample_1_Aligned.sortedByCoord.out,chr16,27371865,27377419,-,12,2,14,known,chr16:27371865-27377419
sample_1_Aligned.sortedByCoord.out,chr5,30476684,30485278,-,10,1,11,known,chr5:30476684-30485278
sample_1_Aligned.sortedByCoord.out,chr11,13507293,13513781,+,9,3,12,novel,chr11:13507293-13513781
sample_1_Aligned.sortedByCoord.out,chr16,28314415,28321195,-,7,3,10,novel,chr16:28314415-28321195
sample_1_Aligned.sortedByCoord.out,chr14,21617463,21619931,-,11,1,12,known,chr14:21617463-21619931
sample_1_Aligned.sortedByCoord.out,chr2,48377287,48387271,-,11,2,13,novel,chr2:48377287-48387271
sample_1_Aligned.sortedByCoord.out,chr4,19327487,19328269,+,13,1,14,known,chr4:19327487-19328269
sample_1_Aligned.sortedByCoord.out,chr6,22536031,22540419,-,12,5,17,known,chr6:22536031-22540419
sample_1_Aligned.sortedByCoord.out,chr4,41033557,41039729,-,7,2,9,known,chr4:41033557-41039729
sample_1_Aligned.sortedByCoord.out,chr22,16712875,16718749,-,10,2,12,known,chr22:16712875-16718749
sample_1_Aligned.sortedByCoord.out,chr1,3643481,3652102,+,11,3,14,known,chr1:3643481-3652102
sample_1_Aligned.sortedByCoord.out,chr17,18900460,18902340,+,7,2,9,known,chr17:18900460-18902340
sample_1_Aligned.sortedByCoord.out,chr10,22997288,23006469,+,12,1,13,novel,chr10:22997288-23006469
sample_1_Aligned.sortedByCoord.out,chr16,3840677,3843888,-,8,0,8,known,chr16:3840677-3843888
sample_1_Aligned.sortedByCoord.out,chr22,35707587,35714314,-,12,4,16,novel,chr22:35707587-35714314
sample_1_Aligned.sortedByCoord.out,chr21,43991710,43997969,+,12,0,12,known,chr21:43991710-43997969
sample_1_Aligned.sortedByCoord.out,chr5,23978895,23988711,+,7,5,12,known,chr5:23978895-23988711
sample_1_Aligned.sortedByCoord.out,chr14,16778219,16779466,-,7,4,11,novel,chr14:16778219-16779466
sample_1_Aligned.sortedByCoord.out,chr17,24273738,24279485,-,11,2,13,known,chr17:24273738-24279485
sample_1_Aligned.sortedByCoord.out,chr7,5300261,5309025,-,14,2,16,known,chr7:5300261-5309025
sample_1_Aligned.sortedByCoord.out,chr3,14696349,14703917,+,13,1,14,known,chr3:14696349-14703917
sample_1_Aligned.sortedByCoord.out,chr4,9575455,9578731,-,8,2,10,known,chr4:9575455-9578731
sample_1_Aligned.sortedByCoord.out,chr22,4634847,4638172,-,15,1,16,known,chr22:4634847-4638172
sample_1_Aligned.sortedByCoord.out,chr1,31106332,31115543,+,16,2,18,known,chr1:31106332-31115543
sample_1_Aligned.sortedByCoord.out,chr14,44430311,44435347,-,16,4,20,known,chr14:44430311-44435347
sample_1_Aligned.sortedByCoord.out,chr3,30315828,30324386,+,9,1,10,known,chr3:30315828-30324386
sample_1_Aligned.sortedByCoord.out,chr21,33029432,33036747,+,12,4,16,known,chr21:33029432-33036747
sample_1_Aligned.sortedByCoord.out,chr21,49248005,49256080,-,12,2,14,novel,chr21:49248005-49256080
sample_1_Aligned.sortedByCoord.out,chr12,25662191,25662759,-,12,2,14,novel,chr12:25662191-25662759
sample_1_Aligned.sortedByCoord.out,chr4,10530959,10535474,-,9,1,10,known,chr4:10530959-10535474
sample_1_Aligned.sortedByCoord.out,chr15,24204371,24208573,+,10,1,11,known,chr15:24204371-24208573
sample_1_Aligned.sortedByCoord.out,chr11,43737375,43740104,-,9,2,11,novel,chr11:43737375-43740104
sample_1_Aligned.sortedByCoord.out,chr13,16058512,16066492,-,6,2,8,known,chr13:16058512-16066492
sample_1_Aligned.sortedByCoord.out,chr14,9188562,9198251,-,7,2,9,known,chr14:9188562-9198251
sample_1_Aligned.sortedByCoord.out,chr8,32961259,32966065,-,6,2,8,known,chr8:32961259-32966065
sample_1_Aligned.sortedByCoord.out,chr13,44687172,44688943,+,12,2,14,novel,chr13:44687172-44688943
sample_1_Aligned.sortedByCoord.out,chr10,43020855,43027148,+,11,3,14,novel,chr10:43020855-43027148
sample_1_Aligned.sortedByCoord.out,chr20,46214816,46217292,+,13,1,14,known,chr20:46214816-46217292
sample_1_Aligned.sortedByCoord.out,chr10,44521490,44522020,+,7,3,10,known,chr10:44521490-44522020
sample_1_Aligned.sortedByCoord.out,chr1,25035735,25042655,+,11,2,13,known,chr1:25035735-25042655
sample_1_Aligned.sortedByCoord.out,chr12,11268992,11271134,-,11,6,17,known,chr12:11268992-11271134
sample_1_Aligned.sortedByCoord.out,chr6,29539598,29540365,-,14,1,15,novel,chr6:29539598-29540365
sample_1_Aligned.sortedByCoord.out,chr18,41210816,41215108,+,13,1,14,known,chr18:41210816-41215108
sample_1_Aligned.sortedByCoord.out,chr22,14795680,14802945,-,11,2,13,known,chr22:14795680-14802945
sample_1_Aligned.sortedByCoord.out,chr9,8439405,8440366,+,11,3,14,known,chr9:8439405-8440366
sample_1_Aligned.sortedByCoord.out,chr2,27597338,27604026,-,9,2,11,known,chr2:27597338-27604026
sample_1_Aligned.sortedByCoord.out,chr6,22588700,22592005,+,8,6,14,known,chr6:22588700-22592005
sample_1_Aligned.sortedByCoord.out,chr1,5689771,5697804,-,15,2,17,novel,chr1:5689771-5697804
sample_1_Aligned.sortedByCoord.out,chr11,46849745,46853076,+,11,6,17,known,chr11:46849745-46853076
sample_1_Aligned.sortedByCoord.out,chr15,40438857,40446304,-,10,2,12,known,chr15:40438857-40446304
sample_1_Aligned.sortedByCoord.out,chr16,48131672,48131909,-,10,1,11,known,chr16:48131672-48131909
sample_1_Aligned.sortedByCoord.out,chr16,48102320,48110098,-,9,1,10,known,chr16:48102320-48110098
sample_1_Aligned.sortedByCoord.out,chr8,24511789,24512841,-,6,7,13,known,chr8:24511789-24512841
sample_1_Aligned.sortedByCoord.out,chr8,7510906,7512530,+,6,3,9,known,chr8:7510906-7512530
sample_1_Aligned.sortedByCoord.out,chr11,49054359,49059410,-,13,2,15,novel,chr11:49054359-49059410
sample_1_Aligned.sortedByCoord.out,chr15,38244808,38254621,-,10,2,12,novel,chr15:38244808-38254621
sample_1_Aligned.sortedByCoord.out,chr3,1542899,1546016,-,12,4,16,known,chr3:1542899-1546016
sample_1_Aligned.sortedByCoord.out,chr9,3307497,3311276,+,8,2,10,known,chr9:3307497-3311276
sample_1_Aligned.sortedByCoord.out,chr3,39355671,39360729,-,14,2,16,known,chr3:39355671-39360729
sample_1_Aligned.sortedByCoord.out,chr4,4844275,4850382,-,14,1,15,known,chr4:4844275-4850382
sample_1_Aligned.sortedByCoord.out,chr8,37004688,37013244,-,8,3,11,known,chr8:37004688-37013244
sample_1_Aligned.sortedByCoord.out,chr3,5555970,5565775,-,10,4,14,known,chr3:5555970-5565775
sample_1_Aligned.sortedByCoord.out,chr7,48654732,48663190,+,14,1,15,known,chr7:48654732-48663190
sample_1_Aligned.sortedByCoord.out,chr2,42025220,42028034,-,13,1,14,known,chr2:42025220-42028034
sample_1_Aligned.sortedByCoord.out,chr13,4548377,4551207,+,7,2,9,known,chr13:4548377-4551207
sample_1_Aligned.sortedByCoord.out,chr1,36769833,36773978,-,9,2,11,known,chr1:36769833-36773978
sample_1_Aligned.sortedByCoord.out,chr10,37486069,37490861,-,11,2,13,known,chr10:37486069-37490861
sample_1_Aligned.sortedByCoord.out,chr4,21115534,21116899,-,10,3,13,known,chr4:21115534-21116899
sample_1_Aligned.sortedByCoord.out,chr14,47262069,47268789,+,6,5,11,known,chr14:47262069-47268789
sample_1_Aligned.sortedByCoord.out,chr3,39137354,39141884,+,7,1,8,novel,chr3:39137354-39141884
sample_1_Aligned.sortedByCoord.out,chr17,22284929,22286796,-,10,2,12,novel,chr17:22284929-22286796
sample_1_Aligned.sortedByCoord.out,chr3,20049279,20055458,-,10,0,10,known,chr3:20049279-20055458
sample_1_Aligned.sortedByCoord.out,chr21,30555881,30560564,-,14,5,19,known,chr21:30555881-30560564
sample_1_Aligned.sortedByCoord.out,chr20,49411020,49419919,+,14,0,14,known,chr20:49411020-49419919
sample_1_Aligned.sortedByCoord.out,chr10,26601544,26606801,+,14,2,16,known,chr10:26601544-26606801
sample_1_Aligned.sortedByCoord.out,chr14,44301873,44303804,+,9,2,11,known,chr14:44301873-44303804
sample_1_Aligned.sortedByCoord.out,chr12,3733933,3736986,-,9,0,9,known,chr12:3733933-3736986
sample_1_Aligned.sortedByCoord.out,chr12,14808250,14813834,-,8,2,10,known,chr12:14808250-14813834
sample_1_Aligned.sortedByCoord.out,chr10,12925212,12926925,-,7,2,9,known,chr10:12925212-12926925
sample_1_Aligned.sortedByCoord.out,chr1,47198764,47201209,+,16,3,19,known,chr1:47198764-47201209
sample_1_Aligned.sortedByCoord.out,chr3,44089179,44094537,+,8,4,12,known,chr3:44089179-44094537
sample_1_Aligned.sortedByCoord.out,chr22,21274922,21281419,-,9,0,9,known,chr22:21274922-21281419
sample_1_Aligned.sortedByCoord.out,chr3,5049944,5051073,+,15,0,15,known,chr3:5049944-5051073
sample_1_Aligned.sortedByCoord.out,chr6,21544570,21550550,-,11,3,14,known,chr6:21544570-21550550
sample_1_Aligned.sortedByCoord.out,chr18,24314082,24318018,-,8,1,9,known,chr18:24314082-24318018
sample_1_Aligned.sortedByCoord.out,chr12,6543633,6552810,+,7,3,10,novel,chr12:6543633-6552810
sample_1_Aligned.sortedByCoord.out,chr14,17551418,17557467,-,9,3,12,known,chr14:17551418-17557467
sample_1_Aligned.sortedByCoord.out,chr1,40722485,40725932,+,9,2,11,known,chr1:40722485-40725932
sample_1_Aligned.sortedByCoord.out,chr1,3286092,3293637,+,9,1,10,known,chr1:3286092-3293637
sample_1_Aligned.sortedByCoord.out,chr10,10129384,10138584,-,8,0,8,known,chr10:10129384-10138584
sample_1_Aligned.sortedByCoord.out,chr1,44173814,44182207,+,11,1,12,known,chr1:44173814-44182207
sample_1_Aligned.sortedByCoord.out,chr2,16435120,16437406,+,10,3,13,known,chr2:16435120-16437406
sample_1_Aligned.sortedByCoord.out,chr18,43917102,43918510,-,18,0,18,known,chr18:43917102-43918510
sample_1_Aligned.sortedByCoord.out,chr21,18633691,18643165,-,3,4,7,known,chr21:18633691-18643165
sample_1_Aligned.sortedByCoord.out,chr11,3259685,3260328,+,8,0,8,known,chr11:3259685-3260328
sample_1_Aligned.sortedByCoord.out,chr1,34980559,34985338,+,9,0,9,known,chr1:34980559-34985338
sample_1_Aligned.sortedByCoord.out,chr2,24389439,24391509,-,5,0,5,novel,chr2:24389439-24391509
sample_1_Aligned.sortedByCoord.out,chr14,7829322,7835300,+,12,2,14,known,chr14:7829322-7835300
sample_1_Aligned.sortedByCoord.out,chr19,41018204,41027459,-,9,4,13,known,chr19:41018204-41027459
sample_1_Aligned.sortedByCoord.out,chr2,27605745,27610908,-,11,4,15,known,chr2:27605745-27610908
sample_1_Aligned.sortedByCoord.out,chr5,38526247,38535904,-,10,2,12,novel,chr5:38526247-38535904
sample_1_Aligned.sortedByCoord.out,chr1,15119606,15120444,-,13,1,14,novel,chr1:15119606-15120444
sample_1_Aligned.sortedByCoord.out,chr13,41801378,41802074,-,10,0,10,known,chr13:41801378-41802074
sample_1_Aligned.sortedByCoord.out,chr8,14142592,14151800,+,4,3,7,known,chr8:14142592-14151800
sample_1_Aligned.sortedByCoord.out,chr2,48933130,48935840,+,10,1,11,known,chr2:48933130-48935840
sample_1_Aligned.sortedByCoord.out,chr21,25752745,25757162,+,9,4,13,known,chr21:25752745-25757162
sample_1_Aligned.sortedByCoord.out,chr12,32126109,32131086,-,9,2,11,novel,chr12:32126109-32131086
sample_1_Aligned.sortedByCoord.out,chr18,44489509,44498514,+,9,3,12,novel,chr18:44489509-44498514
sample_1_Aligned.sortedByCoord.out,chr3,37681050,37690094,-,7,7,14,novel,chr3:37681050-37690094
sample_1_Aligned.sortedByCoord.out,chr11,37292189,37297331,+,11,1,12,known,chr11:37292189-37297331
sample_1_Aligned.sortedByCoord.out,chr20,14479903,14480636,+,11,4,15,known,chr20:14479903-14480636
sample_1_Aligned.sortedByCoord.out,chr9,43971423,43975092,+,6,1,7,known,chr9:43971423-43975092
sample_1_Aligned.sortedByCoord.out,chr18,37716381,37725907,-,10,1,11,known,chr18:37716381-37725907
sample_1_Aligned.sortedByCoord.out,chr5,48028800,48029215,+,8,1,9,known,chr5:48028800-48029215
sample_1_Aligned.sortedByCoord.out,chr7,17168898,17171098,+,15,3,18,known,chr7:17168898-17171098
sample_1_Aligned.sortedByCoord.out,chr5,15598342,15600572,+,10,2,12,known,chr5:15598342-15600572
sample_1_Aligned.sortedByCoord.out,chr8,49491047,49492491,-,10,2,12,known,chr8:49491047-49492491
sample_1_Aligned.sortedByCoord.out,chr9,6559215,6563690,-,9,2,11,known,chr9:6559215-6563690
sample_1_Aligned.sortedByCoord.out,chr9,34214361,34216011,+,12,1,13,known,chr9:34214361-34216011
sample_1_Aligned.sortedByCoord.out,chr21,13822825,13826920,-,12,3,15,known,chr21:13822825-13826920
sample_1_Aligned.sortedByCoord.out,chr9,31253260,31262435,-,16,0,16,known,chr9:31253260-31262435
sample_1_Aligned.sortedByCoord.out,chr13,40804899,40810280,+,6,2,8,known,chr13:40804899-40810280
sample_1_Aligned.sortedByCoord.out,chr8,29704438,29706446,+,12,2,14,known,chr8:29704438-29706446
sample_1_Aligned.sortedByCoord.out,chr22,7011091,7013954,+,6,3,9,known,chr22:7011091-7013954
sample_1_Aligned.sortedByCoord.out,chr13,9879284,9880457,+,10,0,10,known,chr13:9879284-9880457
sample_1_Aligned.sortedByCoord.out,chr2,49282309,49290808,-,12,3,15,known,chr2:49282309-49290808
sample_1_Aligned.sortedByCoord.out,chr1,7847192,7851273,-,16,0,16,known,chr1:7847192-7851273
sample_1_Aligned.sortedByCoord.out,chr4,49924547,49931153,-,10,2,12,known,chr4:49924547-49931153
sample_1_Aligned.sortedByCoord.out,chr3,28170495,28170776,+,7,0,7,known,chr3:28170495-28170776
sample_1_Aligned.sortedByCoord.out,chr21,44893561,44899401,-,9,1,10,known,chr21:44893561-44899401
sample_1_Aligned.sortedByCoord.out,chr8,27484244,27492324,-,12,1,13,known,chr8:27484244-27492324
sample_1_Aligned.sortedByCoord.out,chr8,49523463,49523944,+,11,2,13,known,chr8:49523463-49523944
sample_1_Aligned.sortedByCoord.out,chr8,21230091,21234097,+,12,1,13,known,chr8:21230091-21234097
sample_1_Aligned.sortedByCoord.out,chr1,9357861,9361211,+,10,0,10,known,chr1:9357861-9361211
sample_1_Aligned.sortedByCoord.out,chr6,37141710,37150865,-,3,6,9,known,chr6:37141710-37150865
sample_1_Aligned.sortedByCoord.out,chr9,38121255,38122585,-,5,5,10,known,chr9:38121255-38122585
sample_1_Aligned.sortedByCoord.out,chr5,25697976,25705754,+,8,1,9,novel,chr5:25697976-25705754
sample_1_Aligned.sortedByCoord.out,chr12,16652416,16660953,+,14,2,16,known,chr12:16652416-16660953
sample_1_Aligned.sortedByCoord.out,chr17,24435562,24443966,+,14,2,16,known,chr17:24435562-24443966
sample_1_Aligned.sortedByCoord.out,chr11,23737002,23739746,+,13,1,14,known,chr11:23737002-23739746
sample_1_Aligned.sortedByCoord.out,chr20,37538673,37545771,-,14,2,16,known,chr20:37538673-37545771
sample_1_Aligned.sortedByCoord.out,chr16,20731224,20732543,-,4,4,8,novel,chr16:20731224-20732543
sample_1_Aligned.sortedByCoord.out,chr20,48455630,48459503,+,11,2,13,known,chr20:48455630-48459503
sample_1_Aligned.sortedByCoord.out,chr2,36862561,36867234,+,13,0,13,known,chr2:36862561-36867234
sample_1_Aligned.sortedByCoord.out,chr8,46804598,46810165,-,9,4,13,known,chr8:46804598-46810165
sample_1_Aligned.sortedByCoord.out,chr9,19224641,19232417,+,4,2,6,known,chr9:19224641-19232417
sample_1_Aligned.sortedByCoord.out,chr11,10563832,10568572,+,7,3,10,known,chr11:10563832-10568572
sample_1_Aligned.sortedByCoord.out,chr12,16806780,16810251,-,9,3,12,known,chr12:16806780-16810251
sample_1_Aligned.sortedByCoord.out,chr11,24074498,24076314,-,13,2,15,novel,chr11:24074498-24076314
sample_1_Aligned.sortedByCoord.out,chr7,44256232,44264404,+,6,0,6,known,chr7:44256232-44264404
sample_1_Aligned.sortedByCoord.out,chr20,3579283,3585752,-,9,2,11,known,chr20:3579283-3585752
sample_1_Aligned.sortedByCoord.out,chr2,22187770,22188820,+,11,1,12,known,chr2:22187770-22188820
sample_1_Aligned.sortedByCoord.out,chr3,35607079,35610895,-,6,3,9,known,chr3:35607079-35610895
sample_1_Aligned.sortedByCoord.out,chr21,3259116,3264735,+,7,2,9,known,chr21:3259116-3264735
sample_1_Aligned.sortedByCoord.out,chr13,42644460,42645672,-,12,2,14,novel,chr13:42644460-42645672
sample_1_Aligned.sortedByCoord.out,chr1,9210712,9219278,-,11,1,12,known,chr1:9210712-9219278
sample_1_Aligned.sortedByCoord.out,chr6,11983442,11987449,+,10,0,10,known,chr6:11983442-11987449
sample_1_Aligned.sortedByCoord.out,chr3,35140903,35142004,+,9,2,11,known,chr3:35140903-35142004
sample_1_Aligned.sortedByCoord.out,chr21,46457032,46466908,+,18,2,20,known,chr21:46457032-46466908
sample_1_Aligned.sortedByCoord.out,chr2,44744066,44748583,+,6,3,9,known,chr2:44744066-44748583
sample_1_Aligned.sortedByCoord.out,chr6,7249991,7251940,-,15,1,16,novel,chr6:7249991-7251940
sample_1_Aligned.sortedByCoord.out,chr5,46037366,46047053,+,10,6,16,known,chr5:46037366-46047053
sample_1_Aligned.sortedByCoord.out,chr15,48480964,48489931,+,11,3,14,known,chr15:48480964-48489931
sample_1_Aligned.sortedByCoord.out,chr7,19913409,19915107,+,15,2,17,novel,chr7:19913409-19915107
sample_1_Aligned.sortedByCoord.out,chr2,6723710,6731812,-,5,2,7,known,chr2:6723710-6731812
sample_1_Aligned.sortedByCoord.out,chr17,31725074,31726756,+,6,2,8,known,chr17:31725074-31726756
sample_1_Aligned.sortedByCoord.out,chr18,11270714,11272187,+,12,3,15,known,chr18:11270714-11272187
sample_1_Aligned.sortedByCoord.out,chr1,22440616,22445402,-,9,0,9,known,chr1:22440616-22445402
sample_1_Aligned.sortedByCoord.out,chr3,6386937,6394052,-,20,2,22,known,chr3:6386937-6394052
sample_1_Aligned.sortedByCoord.out,chr7,29881994,29885872,+,9,0,9,known,chr7:29881994-29885872
sample_1_Aligned.sortedByCoord.out,chr15,46296279,46300837,-,4,2,6,known,chr15:46296279-46300837
sample_1_Aligned.sortedByCoord.out,chr1,4145266,4148601,-,13,1,14,known,chr1:4145266-4148601
sample_1_Aligned.sortedByCoord.out,chr7,8181848,8187214,+,9,1,10,known,chr7:8181848-8187214
sample_1_Aligned.sortedByCoord.out,chr20,2664717,2669835,-,11,1,12,novel,chr20:2664717-2669835
sample_1_Aligned.sortedByCoord.out,chr8,2398437,2399791,+,18,0,18,known,chr8:2398437-2399791
sample_1_Aligned.sortedByCoord.out,chr7,43479567,43487852,-,10,2,12,known,chr7:43479567-43487852
sample_1_Aligned.sortedByCoord.out,chr21,14991583,14998090,+,14,2,16,known,chr21:14991583-14998090
sample_1_Aligned.sortedByCoord.out,chr12,39199461,39208928,-,9,2,11,known,chr12:39199461-39208928
sample_1_Aligned.sortedByCoord.out,chr8,30110795,30115893,+,13,2,15,known,chr8:30110795-30115893
sample_1_Aligned.sortedByCoord.out,chr13,41889205,41897658,+,12,2,14,known,chr13:41889205-41897658
sample_1_Aligned.sortedByCoord.out,chr12,23967343,23971486,-,7,2,9,known,chr12:23967343-23971486
sample_1_Aligned.sortedByCoord.out,chr21,20207367,20209447,-,6,3,9,known,chr21:20207367-20209447
sample_1_Aligned.sortedByCoord.out,chr18,21638013,21647688,+,10,2,12,known,chr18:21638013-21647688
sample_1_Aligned.sortedByCoord.out,chr16,49976564,49979669,+,8,1,9,known,chr16:49976564-49979669
sample_1_Aligned.sortedByCoord.out,chr4,20543926,20544649,+,5,3,8,known,chr4:20543926-20544649
sample_1_Aligned.sortedByCoord.out,chr2,14982497,14986005,-,11,0,11,known,chr2:14982497-14986005
sample_1_Aligned.sortedByCoord.out,chr4,19627814,19628918,+,14,7,21,known,chr4:19627814-19628918
sample_1_Aligned.sortedByCoord.out,chr15,36933267,36941895,+,14,4,18,known,chr15:36933267-36941895
sample_1_Aligned.sortedByCoord.out,chr14,31673715,31674262,+,7,3,10,novel,chr14:31673715-31674262
sample_1_Aligned.sortedByCoord.out,chr10,39437003,39440437,+,7,0,7,known,chr10:39437003-39440437
sample_1_Aligned.sortedByCoord.out,chr16,11907811,11914192,-,9,2,11,known,chr16:11907811-11914192
sample_1_Aligned.sortedByCoord.out,chr5,37628336,37633184,-,10,2,12,known,chr5:37628336-37633184
sample_1_Aligned.sortedByCoord.out,chr8,20944078,20945537,-,8,2,10,novel,chr8:20944078-20945537
sample_1_Aligned.sortedByCoord.out,chr13,7098487,7106796,+,9,1,10,novel,chr13:7098487-7106796
sample_1_Aligned.sortedByCoord.out,chr22,14456824,14457807,+,13,2,15,known,chr22:14456824-14457807
sample_1_Aligned.sortedByCoord.out,chr14,20939331,20948607,+,9,8,17,known,chr14:20939331-20948607
sample_1_Aligned.sortedByCoord.out,chr19,37134542,37140188,-,18,5,23,known,chr19:37134542-37140188
sample_1_Aligned.sortedByCoord.out,chr10,48785454,48789475,+,9,0,9,known,chr10:48785454-48789475
sample_1_Aligned.sortedByCoord.out,chr19,26923142,26924506,+,12,1,13,known,chr19:26923142-26924506
sample_1_Aligned.sortedByCoord.out,chr14,48333860,48339764,+,8,2,10,novel,chr14:48333860-48339764
sample_1_Aligned.sortedByCoord.out,chr21,6361359,6369733,-,12,3,15,known,chr21:6361359-6369733
sample_1_Aligned.sortedByCoord.out,chr12,38330237,38340140,-,13,3,16,novel,chr12:38330237-38340140
sample_1_Aligned.sortedByCoord.out,chr14,42536933,42541166,-,7,3,10,known,chr14:42536933-42541166
sample_1_Aligned.sortedByCoord.out,chr5,10051638,10060033,+,10,2,12,known,chr5:10051638-10060033
sample_1_Aligned.sortedByCoord.out,chr12,26858244,26859338,-,14,4,18,known,chr12:26858244-26859338
sample_1_Aligned.sortedByCoord.out,chr3,17102689,17108678,+,10,3,13,known,chr3:17102689-17108678
sample_1_Aligned.sortedByCoord.out,chr15,48687358,48690645,+,9,0,9,known,chr15:48687358-48690645
sample_1_Aligned.sortedByCoord.out,chr21,18095412,18097807,-,9,1,10,known,chr21:18095412-18097807
sample_1_Aligned.sortedByCoord.out,chr3,43785465,43795304,+,11,3,14,novel,chr3:43785465-43795304
sample_1_Aligned.sortedByCoord.out,chr5,37027701,37032021,+,8,0,8,known,chr5:37027701-37032021
sample_1_Aligned.sortedByCoord.out,chr22,48532792,48534127,+,10,2,12,known,chr22:48532792-48534127
sample_1_Aligned.sortedByCoord.out,chr2,33907794,33910983,+,15,3,18,known,chr2:33907794-33910983
sample_1_Aligned.sortedByCoord.out,chr5,27279738,27287155,-,9,3,12,known,chr5:27279738-27287155
sample_1_Aligned.sortedByCoord.out,chr22,42650684,42652241,-,11,2,13,novel,chr22:42650684-42652241
sample_1_Aligned.sortedByCoord.out,chr8,40390898,40391220,+,12,2,14,known,chr8:40390898-40391220
sample_1_Aligned.sortedByCoord.out,chr12,49107835,49117713,+,14,2,16,known,chr12:49107835-49117713
sample_1_Aligned.sortedByCoord.out,chr21,46202983,46205163,-,12,2,14,known,chr21:46202983-46205163
sample_1_Aligned.sortedByCoord.out,chr11,21074929,21083846,-,7,2,9,known,chr11:21074929-21083846
sample_1_Aligned.sortedByCoord.out,chr8,42476874,42478914,-,9,1,10,known,chr8:42476874-42478914
sample_1_Aligned.sortedByCoord.out,chr8,43379021,43382658,+,4,5,9,known,chr8:43379021-43382658
sample_1_Aligned.sortedByCoord.out,chr21,1180778,1186947,+,10,1,11,novel,chr21:1180778-1186947
sample_1_Aligned.sortedByCoord.out,chr12,47214533,47217689,+,9,1,10,novel,chr12:47214533-47217689
sample_1_Aligned.sortedByCoord.out,chr19,23599794,23608380,+,9,2,11,known,chr19:23599794-23608380
sample_1_Aligned.sortedByCoord.out,chr22,19879624,19882948,+,13,3,16,known,chr22:19879624-19882948
sample_1_Aligned.sortedByCoord.out,chr14,34494949,34495753,-,6,1,7,novel,chr14:34494949-34495753
sample_1_Aligned.sortedByCoord.out,chr18,48483283,48484630,+,13,3,16,novel,chr18:48483283-48484630
sample_1_Aligned.sortedByCoord.out,chr8,20077744,20084195,+,10,3,13,novel,chr8:20077744-20084195
sample_1_Aligned.sortedByCoord.out,chr1,39873429,39877329,-,9,3,12,known,chr1:39873429-39877329
sample_1_Aligned.sortedByCoord.out,chr6,29110147,29119818,-,9,1,10,known,chr6:29110147-29119818
sample_1_Aligned.sortedByCoord.out,chr6,31926920,31930378,-,8,3,11,known,chr6:31926920-31930378
sample_1_Aligned.sortedByCoord.out,chr2,3061680,3062240,+,11,2,13,known,chr2:3061680-3062240
sample_1_Aligned.sortedByCoord.out,chr22,21592423,21602000,-,13,4,17,known,chr22:21592423-21602000
sample_1_Aligned.sortedByCoord.out,chr8,10080270,10082016,+,11,2,13,known,chr8:10080270-10082016
sample_1_Aligned.sortedByCoord.out,chr15,29865694,29868240,-,9,2,11,known,chr15:29865694-29868240
sample_1_Aligned.sortedByCoord.out,chr1,31489047,31494726,+,12,3,15,known,chr1:31489047-31494726
sample_1_Aligned.sortedByCoord.out,chr2,12525203,12531886,-,7,1,8,novel,chr2:12525203-12531886
sample_1_Aligned.sortedByCoord.out,chr6,41968632,41973615,-,4,2,6,novel,chr6:41968632-41973615
sample_1_Aligned.sortedByCoord.out,chr6,15764182,15771117,+,14,1,15,known,chr6:15764182-15771117
sample_1_Aligned.sortedByCoord.out,chr7,28587732,28590888,+,13,2,15,known,chr7:28587732-28590888
sample_1_Aligned.sortedByCoord.out,chr20,18171093,18171286,-,14,0,14,known,chr20:18171093-18171286
sample_1_Aligned.sortedByCoord.out,chr2,8900132,8906102,-,10,1,11,known,chr2:8900132-8906102
sample_1_Aligned.sortedByCoord.out,chr10,9044010,9046882,-,8,5,13,known,chr10:9044010-9046882
sample_1_Aligned.sortedByCoord.out,chr21,30975806,30976461,+,7,5,12,known,chr21:30975806-30976461
sample_1_Aligned.sortedByCoord.out,chr11,24839829,24842913,+,12,0,12,known,chr11:24839829-24842913
sample_1_Aligned.sortedByCoord.out,chr4,41694200,41696033,+,8,1,9,known,chr4:41694200-41696033
sample_1_Aligned.sortedByCoord.out,chr4,47103936,47106999,+,6,3,9,known,chr4:47103936-47106999
sample_1_Aligned.sortedByCoord.out,chr6,23900986,23903071,+,10,3,13,known,chr6:23900986-23903071
sample_1_Aligned.sortedByCoord.out,chr18,23153463,23159000,-,9,2,11,known,chr18:23153463-23159000
sample_1_Aligned.sortedByCoord.out,chr22,36781115,36787838,-,11,3,14,known,chr22:36781115-36787838
sample_1_Aligned.sortedByCoord.out,chr8,49849506,49854026,-,10,3,13,known,chr8:49849506-49854026
sample_1_Aligned.sortedByCoord.out,chr15,12698646,12705773,-,9,7,16,known,chr15:12698646-12705773
sample_1_Aligned.sortedByCoord.out,chr16,35393984,35394959,+,9,5,14,known,chr16:35393984-35394959
sample_1_Aligned.sortedByCoord.out,chr9,9159386,9160601,+,7,2,9,known,chr9:9159386-9160601
sample_1_Aligned.sortedByCoord.out,chr11,19495700,19502414,+,5,1,6,known,chr11:19495700-19502414
sample_1_Aligned.sortedByCoord.out,chr7,35494037,35495760,+,8,1,9,known,chr7:35494037-35495760
sample_1_Aligned.sortedByCoord.out,chr8,22333521,22338390,+,13,1,14,novel,chr8:22333521-22338390
sample_1_Aligned.sortedByCoord.out,chr3,23046200,23050673,-,6,4,10,known,chr3:23046200-23050673
sample_1_Aligned.sortedByCoord.out,chr10,26658559,26663284,-,11,1,12,known,chr10:26658559-26663284
sample_1_Aligned.sortedByCoord.out,chr15,39990647,39999976,+,13,1,14,novel,chr15:39990647-39999976
sample_1_Aligned.sortedByCoord.out,chr8,3685055,3686767,-,9,4,13,known,chr8:3685055-3686767
sample_1_Aligned.sortedByCoord.out,chr3,19215750,19218406,-,15,1,16,known,chr3:19215750-19218406
sample_1_Aligned.sortedByCoord.out,chr7,36837800,36845125,-,7,0,7,known,chr7:36837800-36845125
sample_1_Aligned.sortedByCoord.out,chr1,35025819,35029521,+,9,1,10,known,chr1:35025819-35029521
sample_1_Aligned.sortedByCoord.out,chr19,6294296,6295919,+,5,1,6,novel,chr19:6294296-6295919
sample_1_Aligned.sortedByCoord.out,chr1,37492714,37498859,-,10,3,13,known,chr1:37492714-37498859
sample_1_Aligned.sortedByCoord.out,chr2,35164302,35170884,-,8,2,10,known,chr2:35164302-35170884
sample_1_Aligned.sortedByCoord.out,chr13,5726150,5730873,-,11,0,11,known,chr13:5726150-5730873
sample_1_Aligned.sortedByCoord.out,chr21,1951680,1952498,+,8,2,10,known,chr21:1951680-1952498
sample_1_Aligned.sortedByCoord.out,chr9,11863421,11864213,-,9,2,11,known,chr9:11863421-11864213
sample_1_Aligned.sortedByCoord.out,chr19,20535296,20536947,+,11,4,15,known,chr19:20535296-20536947
sample_1_Aligned.sortedByCoord.out,chr15,37679332,37688645,+,7,1,8,novel,chr15:37679332-37688645
sample_1_Aligned.sortedByCoord.out,chr6,47640893,47643611,-,15,3,18,known,chr6:47640893-47643611
sample_1_Aligned.sortedByCoord.out,chr21,26409277,26416958,-,8,4,12,novel,chr21:26409277-26416958
sample_1_Aligned.sortedByCoord.out,chr7,14996209,14998341,+,7,3,10,known,chr7:14996209-14998341
sample_1_Aligned.sortedByCoord.out,chr22,41242866,41245680,-,10,1,11,known,chr22:41242866-41245680
sample_1_Aligned.sortedByCoord.out,chr13,6972923,6977667,+,10,2,12,novel,chr13:6972923-6977667
sample_1_Aligned.sortedByCoord.out,chr5,11038546,11047349,-,5,3,8,known,chr5:11038546-11047349
sample_1_Aligned.sortedByCoord.out,chr3,26607781,26616959,-,11,3,14,novel,chr3:26607781-26616959
sample_1_Aligned.sortedByCoord.out,chr3,43076155,43082729,+,7,0,7,known,chr3:43076155-43082729
sample_1_Aligned.sortedByCoord.out,chr16,3171505,3178581,+,8,4,12,known,chr16:3171505-3178581
sample_1_Aligned.sortedByCoord.out,chr7,12406416,12410190,-,9,3,12,known,chr7:12406416-12410190
sample_1_Aligned.sortedByCoord.out,chr22,41907487,41913418,-,15,2,17,known,chr22:41907487-41913418
sample_1_Aligned.sortedByCoord.out,chr19,22736396,22740430,+,11,0,11,known,chr19:22736396-22740430
sample_1_Aligned.sortedByCoord.out,chr2,35575934,35578359,+,14,0,14,known,chr2:35575934-35578359
sample_1_Aligned.sortedByCoord.out,chr6,39428530,39436012,+,15,3,18,known,chr6:39428530-39436012
sample_1_Aligned.sortedByCoord.out,chr8,21592697,21597661,+,10,3,13,novel,chr8:21592697-21597661
sample_1_Aligned.sortedByCoord.out,chr2,43618455,43626104,+,9,1,10,known,chr2:43618455-43626104
sample_1_Aligned.sortedByCoord.out,chr14,12274769,12279254,-,8,2,10,known,chr14:12274769-12279254
sample_1_Aligned.sortedByCoord.out,chr7,13203834,13207931,+,11,5,16,novel,chr7:13203834-13207931
sample_1_Aligned.sortedByCoord.out,chr15,15889434,15891142,-,9,3,12,known,chr15:15889434-15891142
sample_1_Aligned.sortedByCoord.out,chr18,5931698,5938459,+,10,2,12,known,chr18:5931698-5938459
sample_1_Aligned.sortedByCoord.out,chr4,2957172,2966530,+,11,3,14,known,chr4:2957172-2966530
sample_1_Aligned.sortedByCoord.out,chr17,45739555,45742981,-,9,2,11,known,chr17:45739555-45742981
sample_1_Aligned.sortedByCoord.out,chr19,32808749,32817080,+,9,1,10,known,chr19:32808749-32817080
sample_1_Aligned.sortedByCoord.out,chr22,39728519,39732943,+,5,0,5,known,chr22:39728519-39732943
sample_1_Aligned.sortedByCoord.out,chr10,6547308,6548008,-,9,3,12,known,chr10:6547308-6548008
sample_1_Aligned.sortedByCoord.out,chr8,49597138,49603610,+,10,2,12,known,chr8:49597138-49603610
sample_1_Aligned.sortedByCoord.out,chr13,21323829,21327102,-,9,2,11,known,chr13:21323829-21327102
sample_1_Aligned.sortedByCoord.out,chr4,37035330,37042393,+,8,1,9,known,chr4:37035330-37042393
sample_1_Aligned.sortedByCoord.out,chr19,33297082,33300243,-,7,2,9,known,chr19:33297082-33300243
sample_1_Aligned.sortedByCoord.out,chr9,25416377,25424009,+,11,3,14,known,chr9:25416377-25424009
sample_1_Aligned.sortedByCoord.out,chr19,32549144,32558512,-,6,5,11,known,chr19:32549144-32558512
sample_1_Aligned.sortedByCoord.out,chr9,26241958,26248042,-,12,3,15,known,chr9:26241958-26248042
sample_1_Aligned.sortedByCoord.out,chr5,39934169,39941212,+,5,1,6,known,chr5:39934169-39941212
sample_1_Aligned.sortedByCoord.out,chr8,14447164,14447693,-,11,3,14,known,chr8:14447164-14447693
sample_1_Aligned.sortedByCoord.out,chr9,42880415,42886408,+,10,3,13,known,chr9:42880415-42886408
sample_1_Aligned.sortedByCoord.out,chr14,38865729,38872416,+,17,3,20,known,chr14:38865729-38872416
sample_1_Aligned.sortedByCoord.out,chr11,47376728,47382874,+,9,1,10,known,chr11:47376728-47382874
sample_1_Aligned.sortedByCoord.out,chr3,28288604,28295107,-,14,1,15,known,chr3:28288604-28295107
sample_1_Aligned.sortedByCoord.out,chr2,45380188,45389067,-,12,3,15,known,chr2:45380188-45389067
sample_1_Aligned.sortedByCoord.out,chr1,23596691,23597686,-,8,2,10,known,chr1:23596691-23597686
sample_1_Aligned.sortedByCoord.out,chr3,23425722,23435535,+,11,3,14,known,chr3:23425722-23435535
sample_1_Aligned.sortedByCoord.out,chr17,33574638,33576333,+,5,1,6,novel,chr17:33574638-33576333
sample_1_Aligned.sortedByCoord.out,chr13,34550829,34558087,-,9,2,11,novel,chr13:34550829-34558087
sample_1_Aligned.sortedByCoord.out,chr13,11251204,11254951,-,15,1,16,novel,chr13:11251204-11254951
sample_1_Aligned.sortedByCoord.out,chr9,28148987,28157938,+,7,1,8,known,chr9:28148987-28157938
sample_1_Aligned.sortedByCoord.out,chr13,34331786,34337975,+,10,2,12,known,chr13:34331786-34337975
sample_1_Aligned.sortedByCoord.out,chr4,26996422,27002833,-,12,2,14,known,chr4:26996422-27002833
sample_1_Aligned.sortedByCoord.out,chr11,29400225,29409314,+,7,0,7,known,chr11:29400225-29409314
sample_1_Aligned.sortedByCoord.out,chr11,4654014,4656315,-,6,1,7,known,chr11:4654014-4656315
sample_1_Aligned.sortedByCoord.out,chr12,42538597,42544760,-,10,0,10,novel,chr12:42538597-42544760
sample_1_Aligned.sortedByCoord.out,chr11,42592072,42595351,+,8,1,9,known,chr11:42592072-42595351
sample_1_Aligned.sortedByCoord.out,chr13,19261519,19264607,+,9,1,10,novel,chr13:19261519-19264607
sample_1_Aligned.sortedByCoord.out,chr6,48156155,48160681,-,8,4,12,novel,chr6:48156155-48160681
sample_1_Aligned.sortedByCoord.out,chr20,43931536,43934365,-,7,2,9,known,chr20:43931536-43934365
sample_1_Aligned.sortedByCoord.out,chr3,44707312,44714577,-,13,5,18,known,chr3:44707312-44714577
sample_1_Aligned.sortedByCoord.out,chr6,46448874,46455255,-,7,2,9,known,chr6:46448874-46455255
sample_1_Aligned.sortedByCoord.out,chr1,33508858,33512015,-,9,1,10,known,chr1:33508858-33512015
sample_1_Aligned.sortedByCoord.out,chr14,40457968,40462945,-,8,2,10,known,chr14:40457968-40462945
sample_1_Aligned.sortedByCoord.out,chr7,19877670,19881173,+,8,1,9,known,chr7:19877670-19881173
sample_1_Aligned.sortedByCoord.out,chr10,21270516,21280125,-,7,0,7,known,chr10:21270516-21280125
sample_1_Aligned.sortedByCoord.out,chr10,45727621,45735111,-,11,0,11,known,chr10:45727621-45735111
sample_1_Aligned.sortedByCoord.out,chr3,29235304,29238311,+,9,0,9,known,chr3:29235304-29238311
sample_1_Aligned.sortedByCoord.out,chr15,15949743,15954415,-,8,3,11,known,chr15:15949743-15954415
sample_1_Aligned.sortedByCoord.out,chr13,32346143,32355359,-,12,2,14,known,chr13:32346143-32355359
sample_1_Aligned.sortedByCoord.out,chr12,15479890,15483463,+,15,3,18,known,chr12:15479890-15483463
sample_1_Aligned.sortedByCoord.out,chr19,44057685,44061545,-,13,2,15,novel,chr19:44057685-44061545
sample_1_Aligned.sortedByCoord.out,chr11,35981516,35984151,+,7,2,9,known,chr11:35981516-35984151
sample_1_Aligned.sortedByCoord.out,chr10,25085972,25092563,+,5,0,5,novel,chr10:25085972-25092563
sample_1_Aligned.sortedByCoord.out,chr21,24126837,24133491,-,7,2,9,known,chr21:24126837-24133491
sample_1_Aligned.sortedByCoord.out,chr5,13779155,13787390,+,11,1,12,known,chr5:13779155-13787390
sample_1_Aligned.sortedByCoord.out,chr6,20969671,20979626,-,7,2,9,known,chr6:20969671-20979626
sample_1_Aligned.sortedByCoord.out,chr19,24128091,24135418,-,12,1,13,known,chr19:24128091-24135418
sample_1_Aligned.sortedByCoord.out,chr2,22908009,22916209,+,5,1,6,known,chr2:22908009-22916209
sample_1_Aligned.sortedByCoord.out,chr16,8657110,8664816,-,14,0,14,known,chr16:8657110-8664816
sample_1_Aligned.sortedByCoord.out,chr12,24645994,24655542,-,11,5,16,known,chr12:24645994-24655542
sample_1_Aligned.sortedByCoord.out,chr20,2526479,2531756,-,14,3,17,known,chr20:2526479-2531756
sample_1_Aligned.sortedByCoord.out,chr8,27521915,27531528,-,6,5,11,known,chr8:27521915-27531528
sample_1_Aligned.sortedByCoord.out,chr1,47603268,47612826,-,13,2,15,known,chr1:47603268-47612826
sample_1_Aligned.sortedByCoord.out,chr18,32423655,32430476,+,7,5,12,known,chr18:32423655-32430476
sample_1_Aligned.sortedByCoord.out,chr4,13421095,13422537,+,14,3,17,known,chr4:13421095-13422537
sample_1_Aligned.sortedByCoord.out,chr7,36334173,36343526,+,7,2,9,known,chr7:36334173-36343526
sample_1_Aligned.sortedByCoord.out,chr5,9723817,9733056,-,10,3,13,known,chr5:9723817-9733056
sample_1_Aligned.sortedByCoord.out,chr2,14670279,14674412,-,12,1,13,novel,chr2:14670279-14674412
sample_1_Aligned.sortedByCoord.out,chr17,45932704,45939977,+,12,3,15,known,chr17:45932704-45939977
sample_1_Aligned.sortedByCoord.out,chr8,21286174,21295611,+,14,1,15,known,chr8:21286174-21295611
sample_1_Aligned.sortedByCoord.out,chr19,21446906,21449965,-,6,3,9,known,chr19:21446906-21449965
sample_1_Aligned.sortedByCoord.out,chr14,6889265,6897535,+,9,1,10,known,chr14:6889265-6897535
sample_1_Aligned.sortedByCoord.out,chr4,25196236,25200062,+,12,2,14,known,chr4:25196236-25200062
sample_1_Aligned.sortedByCoord.out,chr11,13983228,13990344,-,9,4,13,known,chr11:13983228-13990344
sample_1_Aligned.sortedByCoord.out,chr3,46352796,46357109,+,11,3,14,novel,chr3:46352796-46357109
sample_1_Aligned.sortedByCoord.out,chr6,6874611,6881979,-,6,3,9,novel,chr6:6874611-6881979
sample_1_Aligned.sortedByCoord.out,chr4,24094979,24098292,+,7,2,9,known,chr4:24094979-24098292
sample_1_Aligned.sortedByCoord.out,chr13,23737517,23741099,+,6,2,8,known,chr13:23737517-23741099
sample_1_Aligned.sortedByCoord.out,chr20,13832830,13841198,-,12,1,13,known,chr20:13832830-13841198
sample_1_Aligned.sortedByCoord.out,chr8,42744557,42753514,-,12,3,15,novel,chr8:42744557-42753514
sample_1_Aligned.sortedByCoord.out,chr9,46593401,46598031,-,10,4,14,known,chr9:46593401-46598031
sample_1_Aligned.sortedByCoord.out,chr20,31438231,31439318,-,8,2,10,known,chr20:31438231-31439318
sample_1_Aligned.sortedByCoord.out,chr13,30425233,30430883,-,14,3,17,known,chr13:30425233-30430883
sample_1_Aligned.sortedByCoord.out,chr8,44325477,44328155,+,11,3,14,known,chr8:44325477-44328155
sample_1_Aligned.sortedByCoord.out,chr5,6538705,6541842,-,8,1,9,novel,chr5:6538705-6541842
sample_1_Aligned.sortedByCoord.out,chr7,24921590,24930744,-,11,1,12,known,chr7:24921590-24930744
sample_1_Aligned.sortedByCoord.out,chr1,45310821,45319970,-,7,3,10,known,chr1:45310821-45319970
sample_1_Aligned.sortedByCoord.out,chr4,38507230,38512746,+,11,2,13,known,chr4:38507230-38512746
sample_1_Aligned.sortedByCoord.out,chr21,35111661,35120311,+,13,2,15,known,chr21:35111661-35120311
sample_1_Aligned.sortedByCoord.out,chr22,2867523,2870851,+,11,1,12,known,chr22:2867523-2870851
sample_1_Aligned.sortedByCoord.out,chr13,47784349,47790691,-,6,3,9,known,chr13:47784349-47790691
sample_1_Aligned.sortedByCoord.out,chr18,1060776,1068320,-,8,2,10,known,chr18:1060776-1068320
sample_1_Aligned.sortedByCoord.out,chr9,3616843,3623949,-,10,0,10,novel,chr9:3616843-3623949
sample_1_Aligned.sortedByCoord.out,chr22,8619337,8627849,+,8,6,14,known,chr22:8619337-8627849
sample_1_Aligned.sortedByCoord.out,chr10,4550255,4559540,-,16,2,18,known,chr10:4550255-4559540
sample_1_Aligned.sortedByCoord.out,chr12,18657407,18662490,-,9,5,14,known,chr12:18657407-18662490
sample_1_Aligned.sortedByCoord.out,chr22,21755634,21757253,-,7,1,8,known,chr22:21755634-21757253
sample_1_Aligned.sortedByCoord.out,chr4,38727752,38730346,-,14,4,18,known,chr4:38727752-38730346
sample_1_Aligned.sortedByCoord.out,chr13,49697211,49700763,+,6,4,10,known,chr13:49697211-49700763
sample_1_Aligned.sortedByCoord.out,chr6,39930688,39932935,-,8,2,10,known,chr6:39930688-39932935
sample_1_Aligned.sortedByCoord.out,chr20,3538661,3539411,-,8,2,10,novel,chr20:3538661-3539411
sample_1_Aligned.sortedByCoord.out,chr7,16514884,16523115,+,15,0,15,known,chr7:16514884-16523115
sample_1_Aligned.sortedByCoord.out,chr20,42427254,42428198,-,10,1,11,known,chr20:42427254-42428198
sample_1_Aligned.sortedByCoord.out,chr5,2872107,2873692,-,4,3,7,known,chr5:2872107-2873692
sample_1_Aligned.sortedByCoord.out,chr5,31711090,31719917,-,10,1,11,known,chr5:31711090-31719917
sample_1_Aligned.sortedByCoord.out,chr3,47305222,47313788,-,7,0,7,known,chr3:47305222-47313788
sample_1_Aligned.sortedByCoord.out,chr15,8385156,8388277,-,8,1,9,known,chr15:8385156-8388277
sample_1_Aligned.sortedByCoord.out,chr19,31571696,31576997,+,9,1,10,known,chr19:31571696-31576997
sample_1_Aligned.sortedByCoord.out,chr5,44883967,44890467,+,9,0,9,known,chr5:44883967-44890467
sample_1_Aligned.sortedByCoord.out,chr13,9212345,9221808,+,9,1,10,novel,chr13:9212345-9221808
sample_1_Aligned.sortedByCoord.out,chr15,23976912,23981621,+,13,3,16,known,chr15:23976912-23981621
sample_1_Aligned.sortedByCoord.out,chr20,24490153,24492771,+,8,3,11,known,chr20:24490153-24492771
sample_1_Aligned.sortedByCoord.out,chr21,20146187,20153953,-,9,3,12,known,chr21:20146187-20153953
sample_1_Aligned.sortedByCoord.out,chr10,7736526,7737641,-,14,3,17,known,chr10:7736526-7737641
sample_1_Aligned.sortedByCoord.out,chr10,34047031,34047456,+,7,4,11,novel,chr10:34047031-34047456
sample_1_Aligned.sortedByCoord.out,chr5,34325169,34330943,-,11,1,12,known,chr5:34325169-34330943
sample_1_Aligned.sortedByCoord.out,chr20,15851210,15861023,-,5,2,7,known,chr20:15851210-15861023
sample_1_Aligned.sortedByCoord.out,chr2,13575996,13584361,+,16,3,19,known,chr2:13575996-13584361
sample_1_Aligned.sortedByCoord.out,chr3,33692258,33699302,-,6,1,7,known,chr3:33692258-33699302
sample_1_Aligned.sortedByCoord.out,chr3,44805868,44814463,-,10,1,11,known,chr3:44805868-44814463
sample_1_Aligned.sortedByCoord.out,chr16,9265679,9267389,+,6,4,10,known,chr16:9265679-9267389
sample_1_Aligned.sortedByCoord.out,chr17,21137665,21145768,-,7,2,9,known,chr17:21137665-21145768
sample_1_Aligned.sortedByCoord.out,chr15,5171193,5180618,+,12,4,16,known,chr15:5171193-5180618
sample_1_Aligned.sortedByCoord.out,chr19,10841631,10847233,+,7,4,11,known,chr19:10841631-10847233
sample_1_Aligned.sortedByCoord.out,chr5,9577164,9578455,+,5,3,8,known,chr5:9577164-9578455
sample_1_Aligned.sortedByCoord.out,chr15,49394919,49395960,+,8,5,13,known,chr15:49394919-49395960
sample_1_Aligned.sortedByCoord.out,chr5,14060122,14068707,+,9,1,10,known,chr5:14060122-14068707
sample_1_Aligned.sortedByCoord.out,chr19,2720956,2727589,-,10,4,14,known,chr19:2720956-2727589
sample_1_Aligned.sortedByCoord.out,chr16,3096806,3103092,+,12,2,14,known,chr16:3096806-3103092
sample_1_Aligned.sortedByCoord.out,chr12,49222388,49228365,-,9,1,10,known,chr12:49222388-49228365
sample_1_Aligned.sortedByCoord.out,chr2,32669785,32678541,-,7,1,8,known,chr2:32669785-32678541
sample_1_Aligned.sortedByCoord.out,chr10,19625639,19628106,-,8,1,9,known,chr10:19625639-19628106
sample_1_Aligned.sortedByCoord.out,chr2,23960643,23970059,-,13,1,14,known,chr2:23960643-23970059
sample_1_Aligned.sortedByCoord.out,chr10,10478559,10479228,+,5,0,5,known,chr10:10478559-10479228
sample_1_Aligned.sortedByCoord.out,chr17,2302934,2312214,+,19,3,22,novel,chr17:2302934-2312214
sample_1_Aligned.sortedByCoord.out,chr18,6841928,6842902,-,8,3,11,known,chr18:6841928-6842902
sample_1_Aligned.sortedByCoord.out,chr6,27953966,27955548,-,7,4,11,known,chr6:27953966-27955548
sample_1_Aligned.sortedByCoord.out,chr8,34908346,34910198,+,10,2,12,known,chr8:34908346-34910198
sample_1_Aligned.sortedByCoord.out,chr18,26813058,26823027,+,4,2,6,known,chr18:26813058-26823027
sample_1_Aligned.sortedByCoord.out,chr12,12032577,12036000,+,13,1,14,known,chr12:12032577-12036000
sample_1_Aligned.sortedByCoord.out,chr6,4677273,4679474,-,9,1,10,known,chr6:4677273-4679474
sample_1_Aligned.sortedByCoord.out,chr7,28755677,28761505,+,10,5,15,novel,chr7:28755677-28761505
sample_1_Aligned.sortedByCoord.out,chr2,18936652,18939059,-,11,3,14,known,chr2:18936652-18939059
sample_1_Aligned.sortedByCoord.out,chr4,36509279,36510987,-,6,0,6,novel,chr4:36509279-36510987
sample_1_Aligned.sortedByCoord.out,chr3,16499808,16500552,+,6,3,9,novel,chr3:16499808-16500552
sample_1_Aligned.sortedByCoord.out,chr22,42683840,42692306,+,8,1,9,novel,chr22:42683840-42692306
sample_1_Aligned.sortedByCoord.out,chr8,3706979,3713713,+,8,2,10,novel,chr8:3706979-3713713
sample_1_Aligned.sortedByCoord.out,chr1,6186310,6191315,-,9,4,13,known,chr1:6186310-6191315
sample_1_Aligned.sortedByCoord.out,chr20,35855484,35861210,-,12,2,14,known,chr20:35855484-35861210
sample_1_Aligned.sortedByCoord.out,chr18,14996191,14997518,-,4,2,6,known,chr18:14996191-14997518
sample_1_Aligned.sortedByCoord.out,chr21,41506081,41513394,-,5,3,8,known,chr21:41506081-41513394
sample_1_Aligned.sortedByCoord.out,chr1,49285211,49290220,+,15,1,16,novel,chr1:49285211-49290220
sample_1_Aligned.sortedByCoord.out,chr14,19312340,19316079,+,10,1,11,known,chr14:19312340-19316079
sample_1_Aligned.sortedByCoord.out,chr9,42854866,42859965,+,16,0,16,novel,chr9:42854866-42859965
sample_1_Aligned.sortedByCoord.out,chr8,48143690,48152510,-,11,0,11,known,chr8:48143690-48152510
sample_1_Aligned.sortedByCoord.out,chr21,18993843,18997940,-,12,1,13,known,chr21:18993843-18997940
sample_1_Aligned.sortedByCoord.out,chr21,23187381,23193600,+,9,0,9,known,chr21:23187381-23193600
sample_1_Aligned.sortedByCoord.out,chr16,27643191,27651890,+,18,3,21,known,chr16:27643191-27651890
sample_1_Aligned.sortedByCoord.out,chr4,2416616,2423347,+,9,1,10,known,chr4:2416616-2423347
sample_1_Aligned.sortedByCoord.out,chr19,13665664,13665910,-,13,2,15,known,chr19:13665664-13665910
sample_1_Aligned.sortedByCoord.out,chr12,34215323,34225220,-,9,1,10,known,chr12:34215323-34225220
sample_1_Aligned.sortedByCoord.out,chr17,47753754,47760878,+,12,1,13,novel,chr17:47753754-47760878
sample_1_Aligned.sortedByCoord.out,chr15,27823482,27825633,+,5,0,5,known,chr15:27823482-27825633
sample_1_Aligned.sortedByCoord.out,chr7,27649880,27659830,+,7,0,7,known,chr7:27649880-27659830
sample_1_Aligned.sortedByCoord.out,chr11,27700842,27704017,-,9,2,11,known,chr11:27700842-27704017
sample_1_Aligned.sortedByCoord.out,chr7,32101526,32102828,+,12,2,14,known,chr7:32101526-32102828
sample_1_Aligned.sortedByCoord.out,chr22,29709442,29714998,-,11,1,12,novel,chr22:29709442-29714998
sample_1_Aligned.sortedByCoord.out,chr22,2995242,2997017,-,8,2,10,known,chr22:2995242-2997017
sample_1_Aligned.sortedByCoord.out,chr3,38004412,38012455,-,11,1,12,known,chr3:38004412-38012455
sample_1_Aligned.sortedByCoord.out,chr15,1113907,1121328,-,5,4,9,known,chr15:1113907-1121328
sample_1_Aligned.sortedByCoord.out,chr13,30855714,30860724,-,12,1,13,novel,chr13:30855714-30860724
sample_1_Aligned.sortedByCoord.out,chr5,44794745,44796205,+,9,3,12,known,chr5:44794745-44796205
sample_1_Aligned.sortedByCoord.out,chr20,28419278,28420853,-,16,4,20,known,chr20:28419278-28420853
sample_1_Aligned.sortedByCoord.out,chr13,5608726,5616408,+,11,1,12,known,chr13:5608726-5616408
sample_1_Aligned.sortedByCoord.out,chr3,40043444,40050242,+,9,2,11,known,chr3:40043444-40050242
sample_1_Aligned.sortedByCoord.out,chr1,8909697,8919080,-,12,2,14,known,chr1:8909697-8919080
sample_1_Aligned.sortedByCoord.out,chr1,8442316,8442451,-,9,2,11,known,chr1:8442316-8442451
sample_1_Aligned.sortedByCoord.out,chr6,23659736,23662334,+,16,1,17,known,chr6:23659736-23662334
sample_1_Aligned.sortedByCoord.out,chr7,22233055,22240620,+,7,1,8,known,chr7:22233055-22240620
sample_1_Aligned.sortedByCoord.out,chr2,12508587,12509696,+,10,3,13,known,chr2:12508587-12509696
sample_1_Aligned.sortedByCoord.out,chr3,26168267,26171514,-,9,1,10,known,chr3:26168267-26171514
sample_1_Aligned.sortedByCoord.out,chr4,12396471,12404448,-,9,0,9,known,chr4:12396471-12404448
sample_1_Aligned.sortedByCoord.out,chr2,20277106,20278472,+,14,1,15,known,chr2:20277106-20278472
sample_1_Aligned.sortedByCoord.out,chr22,13921629,13928461,+,15,3,18,known,chr22:13921629-13928461
sample_1_Aligned.sortedByCoord.out,chr6,15423373,15428702,+,16,5,21,known,chr6:15423373-15428702
sample_1_Aligned.sortedByCoord.out,chr14,6977880,6987280,-,10,1,11,known,chr14:6977880-6987280
sample_1_Aligned.sortedByCoord.out,chr17,37712031,37712387,+,8,4,12,known,chr17:37712031-37712387
sample_1_Aligned.sortedByCoord.out,chr12,45890533,45898801,-,17,0,17,known,chr12:45890533-45898801
sample_1_Aligned.sortedByCoord.out,chr21,15794453,15802696,+,12,2,14,known,chr21:15794453-15802696
sample_1_Aligned.sortedByCoord.out,chr11,48197092,48201218,-,9,2,11,novel,chr11:48197092-48201218
sample_1_Aligned.sortedByCoord.out,chr8,36188563,36188676,-,8,6,14,known,chr8:36188563-36188676
sample_1_Aligned.sortedByCoord.out,chr10,28352087,28353999,-,8,3,11,novel,chr10:28352087-28353999
sample_1_Aligned.sortedByCoord.out,chr20,24106153,24111831,+,13,3,16,known,chr20:24106153-24111831
sample_1_Aligned.sortedByCoord.out,chr1,22305029,22311605,+,7,1,8,novel,chr1:22305029-22311605
sample_1_Aligned.sortedByCoord.out,chr4,1288904,1292172,+,15,2,17,known,chr4:1288904-1292172
sample_1_Aligned.sortedByCoord.out,chr13,28244113,28253231,-,8,5,13,known,chr13:28244113-28253231
sample_1_Aligned.sortedByCoord.out,chr2,20330359,20334812,-,9,1,10,known,chr2:20330359-20334812
sample_1_Aligned.sortedByCoord.out,chr9,30178629,30178990,-,9,0,9,known,chr9:30178629-30178990
sample_1_Aligned.sortedByCoord.out,chr1,8189626,8198893,+,7,1,8,novel,chr1:8189626-8198893
sample_1_Aligned.sortedByCoord.out,chr19,42564885,42571513,+,9,3,12,known,chr19:42564885-42571513
sample_1_Aligned.sortedByCoord.out,chr8,49344002,49344323,-,11,2,13,known,chr8:49344002-49344323
sample_1_Aligned.sortedByCoord.out,chr10,48242162,48245707,-,5,0,5,known,chr10:48242162-48245707
sample_1_Aligned.sortedByCoord.out,chr6,30302211,30302887,+,15,5,20,known,chr6:30302211-30302887
sample_1_Aligned.sortedByCoord.out,chr17,39007809,39011603,-,7,1,8,known,chr17:39007809-39011603
sample_1_Aligned.sortedByCoord.out,chr22,38010122,38014661,+,8,1,9,known,chr22:38010122-38014661
sample_1_Aligned.sortedByCoord.out,chr7,23873921,23876831,-,7,1,8,known,chr7:23873921-23876831
sample_1_Aligned.sortedByCoord.out,chr20,46936084,46942162,+,17,1,18,known,chr20:46936084-46942162
sample_1_Aligned.sortedByCoord.out,chr9,21089114,21090835,-,8,1,9,known,chr9:21089114-21090835
sample_1_Aligned.sortedByCoord.out,chr17,18675865,18677817,-,12,1,13,known,chr17:18675865-18677817
sample_1_Aligned.sortedByCoord.out,chr9,7077247,7086350,+,10,1,11,known,chr9:7077247-7086350
sample_1_Aligned.sortedByCoord.out,chr22,16154663,16161230,+,11,3,14,known,chr22:16154663-16161230
sample_1_Aligned.sortedByCoord.out,chr11,44014440,44015120,+,9,4,13,known,chr11:44014440-44015120
sample_1_Aligned.sortedByCoord.out,chr6,20004214,20011981,-,14,1,15,known,chr6:20004214-20011981
sample_1_Aligned.sortedByCoord.out,chr18,7094043,7094539,+,12,1,13,known,chr18:7094043-7094539
sample_1_Aligned.sortedByCoord.out,chr19,43286916,43287703,-,7,3,10,known,chr19:43286916-43287703
sample_1_Aligned.sortedByCoord.out,chr20,49526060,49533053,+,6,1,7,known,chr20:49526060-49533053
sample_1_Aligned.sortedByCoord.out,chr1,9280622,9285952,-,5,2,7,known,chr1:9280622-9285952
sample_1_Aligned.sortedByCoord.out,chr17,37920631,37927299,-,14,1,15,novel,chr17:37920631-37927299
sample_1_Aligned.sortedByCoord.out,chr5,40965218,40965671,+,8,2,10,known,chr5:40965218-40965671
sample_1_Aligned.sortedByCoord.out,chr9,23135709,23141375,+,15,1,16,known,chr9:23135709-23141375
sample_1_Aligned.sortedByCoord.out,chr16,39250776,39260507,+,12,2,14,known,chr16:39250776-39260507
sample_1_Aligned.sortedByCoord.out,chr9,29513618,29518386,-,12,3,15,known,chr9:29513618-29518386
sample_1_Aligned.sortedByCoord.out,chr11,49117889,49122033,-,12,0,12,known,chr11:49117889-49122033
sample_1_Aligned.sortedByCoord.out,chr2,6554196,6556055,+,11,2,13,novel,chr2:6554196-6556055
sample_1_Aligned.sortedByCoord.out,chr16,21542821,21546104,-,15,4,19,known,chr16:21542821-21546104
sample_1_Aligned.sortedByCoord.out,chr19,48716739,48718717,+,12,3,15,known,chr19:48716739-48718717
sample_1_Aligned.sortedByCoord.out,chr9,27695929,27700720,+,8,1,9,known,chr9:27695929-27700720
sample_1_Aligned.sortedByCoord.out,chr7,48253128,48262313,+,8,0,8,known,chr7:48253128-48262313
sample_1_Aligned.sortedByCoord.out,chr3,17574826,17575091,-,7,2,9,known,chr3:17574826-17575091
sample_1_Aligned.sortedByCoord.out,chr1,1263842,1266005,-,14,0,14,known,chr1:1263842-1266005
sample_1_Aligned.sortedByCoord.out,chr6,26622245,26629020,+,10,2,12,novel,chr6:26622245-26629020
sample_1_Aligned.sortedByCoord.out,chr20,18282681,18284521,+,7,0,7,novel,chr20:18282681-18284521
sample_1_Aligned.sortedByCoord.out,chr3,1986510,1993676,+,12,2,14,known,chr3:1986510-1993676
sample_1_Aligned.sortedByCoord.out,chr18,30630414,30631805,+,8,4,12,known,chr18:30630414-30631805
sample_1_Aligned.sortedByCoord.out,chr20,43121736,43130681,-,7,2,9,known,chr20:43121736-43130681
sample_1_Aligned.sortedByCoord.out,chr1,13928132,13932287,-,6,0,6,known,chr1:13928132-13932287
sample_1_Aligned.sortedByCoord.out,chr20,24414531,24414652,+,11,1,12,known,chr20:24414531-24414652
sample_1_Aligned.sortedByCoord.out,chr9,26866656,26868869,+,13,1,14,known,chr9:26866656-26868869
sample_1_Aligned.sortedByCoord.out,chr20,37019234,37022700,-,11,1,12,known,chr20:37019234-37022700
sample_1_Aligned.sortedByCoord.out,chr11,35483926,35485599,-,7,1,8,novel,chr11:35483926-35485599
sample_1_Aligned.sortedByCoord.out,chr19,9484149,9491497,+,11,2,13,known,chr19:9484149-9491497
sample_1_Aligned.sortedByCoord.out,chr4,40194763,40204541,+,5,0,5,known,chr4:40194763-40204541
sample_1_Aligned.sortedByCoord.out,chr18,3433947,3438167,-,15,3,18,known,chr18:3433947-3438167
sample_1_Aligned.sortedByCoord.out,chr18,6579819,6586003,-,14,0,14,novel,chr18:6579819-6586003
sample_1_Aligned.sortedByCoord.out,chr20,35016769,35021879,+,7,3,10,known,chr20:35016769-35021879
sample_1_Aligned.sortedByCoord.out,chr9,9919215,9925041,-,9,2,11,known,chr9:9919215-9925041
sample_1_Aligned.sortedByCoord.out,chr16,25676253,25680862,+,9,1,10,known,chr16:25676253-25680862
sample_1_Aligned.sortedByCoord.out,chr15,41329265,41337304,-,7,3,10,known,chr15:41329265-41337304
sample_1_Aligned.sortedByCoord.out,chr5,2733853,2736720,+,13,2,15,known,chr5:2733853-2736720
sample_1_Aligned.sortedByCoord.out,chr7,36669557,36677907,-,7,3,10,known,chr7:36669557-36677907
sample_1_Aligned.sortedByCoord.out,chr21,7968000,7969988,-,5,3,8,known,chr21:7968000-7969988
sample_1_Aligned.sortedByCoord.out,chr6,15712322,15714640,+,11,0,11,novel,chr6:15712322-15714640
sample_1_Aligned.sortedByCoord.out,chr4,29790147,29796620,+,7,0,7,novel,chr4:29790147-29796620
sample_1_Aligned.sortedByCoord.out,chr17,45625887,45630719,+,12,2,14,known,chr17:45625887-45630719
sample_1_Aligned.sortedByCoord.out,chr16,27665678,27674805,+,14,5,19,known,chr16:27665678-27674805
sample_1_Aligned.sortedByCoord.out,chr14,20968286,20977230,+,8,0,8,known,chr14:20968286-20977230
sample_1_Aligned.sortedByCoord.out,chr3,11321027,11329432,-,13,2,15,known,chr3:11321027-11329432
sample_1_Aligned.sortedByCoord.out,chr16,46950137,46958914,-,14,4,18,novel,chr16:46950137-46958914
sample_1_Aligned.sortedByCoord.out,chr10,7131602,7138434,-,10,4,14,known,chr10:7131602-7138434
sample_1_Aligned.sortedByCoord.out,chr22,41791963,41795133,+,10,1,11,known,chr22:41791963-41795133
sample_1_Aligned.sortedByCoord.out,chr12,45125970,45129774,-,5,0,5,known,chr12:45125970-45129774
sample_1_Aligned.sortedByCoord.out,chr16,21824168,21831058,+,11,3,14,known,chr16:21824168-21831058
sample_1_Aligned.sortedByCoord.out,chr19,17556548,17561047,+,7,3,10,known,chr19:17556548-17561047
sample_1_Aligned.sortedByCoord.out,chr17,45518360,45524526,+,11,5,16,novel,chr17:45518360-45524526
sample_1_Aligned.sortedByCoord.out,chr2,30711622,30716211,+,10,4,14,known,chr2:30711622-30716211
sample_1_Aligned.sortedByCoord.out,chr1,2110878,2118491,+,3,2,5,known,chr1:2110878-2118491
sample_1_Aligned.sortedByCoord.out,chr18,41697153,41701806,+,9,1,10,novel,chr18:41697153-41701806
sample_1_Aligned.sortedByCoord.out,chr4,16736752,16746463,+,9,5,14,novel,chr4:16736752-16746463
sample_1_Aligned.sortedByCoord.out,chr22,25476100,25482750,+,17,2,19,known,chr22:25476100-25482750
sample_1_Aligned.sortedByCoord.out,chr22,49143765,49147422,+,13,1,14,known,chr22:49143765-49147422
sample_1_Aligned.sortedByCoord.out,chr2,17445036,17452384,-,8,1,9,known,chr2:17445036-17452384
sample_1_Aligned.sortedByCoord.out,chr9,45709454,45714570,-,19,1,20,known,chr9:45709454-45714570
sample_1_Aligned.sortedByCoord.out,chr8,3542010,3547812,+,7,5,12,known,chr8:3542010-3547812
sample_1_Aligned.sortedByCoord.out,chr18,19822404,19828045,+,11,0,11,known,chr18:19822404-19828045
sample_1_Aligned.sortedByCoord.out,chr3,1336434,1339269,-,12,3,15,novel,chr3:1336434-1339269
sample_1_Aligned.sortedByCoord.out,chr10,27347555,27355856,-,11,2,13,known,chr10:27347555-27355856
sample_1_Aligned.sortedByCoord.out,chr17,47677568,47679208,+,8,5,13,known,chr17:47677568-47679208
sample_1_Aligned.sortedByCoord.out,chr1,1111441,1120526,+,12,0,12,known,chr1:1111441-1120526
sample_1_Aligned.sortedByCoord.out,chr11,24338472,24343715,-,9,3,12,known,chr11:24338472-24343715
sample_1_Aligned.sortedByCoord.out,chr16,39905638,39909521,+,12,3,15,known,chr16:39905638-39909521
sample_1_Aligned.sortedByCoord.out,chr9,42042303,42051461,-,19,2,21,known,chr9:42042303-42051461
sample_1_Aligned.sortedByCoord.out,chr14,25344044,25351191,+,7,6,13,known,chr14:25344044-25351191
sample_1_Aligned.sortedByCoord.out,chr7,31342632,31350577,+,11,2,13,known,chr7:31342632-31350577
sample_1_Aligned.sortedByCoord.out,chr21,8684833,8689717,-,9,3,12,known,chr21:8684833-8689717
sample_1_Aligned.sortedByCoord.out,chr7,29567260,29570882,-,9,1,10,novel,chr7:29567260-29570882
sample_1_Aligned.sortedByCoord.out,chr16,3838786,3845952,-,9,1,10,novel,chr16:3838786-3845952
sample_1_Aligned.sortedByCoord.out,chr17,22724972,22727473,-,7,3,10,novel,chr17:22724972-22727473
sample_1_Aligned.sortedByCoord.out,chr19,43123810,43130725,-,10,4,14,known,chr19:43123810-43130725
sample_1_Aligned.sortedByCoord.out,chr2,16954044,16962647,-,11,1,12,known,chr2:16954044-16962647
sample_1_Aligned.sortedByCoord.out,chr11,31580951,31587520,-,6,0,6,novel,chr11:31580951-31587520
sample_1_Aligned.sortedByCoord.out,chr10,43769205,43776267,+,13,1,14,known,chr10:43769205-43776267
sample_1_Aligned.sortedByCoord.out,chr20,25356055,25359821,-,15,2,17,known,chr20:25356055-25359821
sample_1_Aligned.sortedByCoord.out,chr21,46850099,46853704,+,7,3,10,known,chr21:46850099-46853704
sample_1_Aligned.sortedByCoord.out,chr3,40847229,40848950,+,14,3,17,known,chr3:40847229-40848950
sample_1_Aligned.sortedByCoord.out,chr8,44026671,44027399,+,17,4,21,known,chr8:44026671-44027399
sample_1_Aligned.sortedByCoord.out,chr22,37835015,37843351,-,9,2,11,known,chr22:37835015-37843351
sample_1_Aligned.sortedByCoord.out,chr6,34923699,34923941,+,5,1,6,known,chr6:34923699-34923941
sample_1_Aligned.sortedByCoord.out,chr7,29462270,29470368,+,8,2,10,known,chr7:29462270-29470368
sample_1_Aligned.sortedByCoord.out,chr8,29952951,29955039,+,10,1,11,known,chr8:29952951-29955039
sample_1_Aligned.sortedByCoord.out,chr11,12883740,12885645,+,12,2,14,known,chr11:12883740-12885645
sample_1_Aligned.sortedByCoord.out,chr7,2227966,2232908,-,9,1,10,known,chr7:2227966-2232908
sample_1_Aligned.sortedByCoord.out,chr9,38850732,38857795,+,8,5,13,known,chr9:38850732-38857795
sample_1_Aligned.sortedByCoord.out,chr12,23757999,23765707,-,14,2,16,novel,chr12:23757999-23765707
sample_1_Aligned.sortedByCoord.out,chr10,42585501,42589507,-,12,4,16,novel,chr10:42585501-42589507
sample_1_Aligned.sortedByCoord.out,chr14,22876518,22878014,-,9,2,11,known,chr14:22876518-22878014
sample_1_Aligned.sortedByCoord.out,chr15,32698707,32700010,+,10,3,13,known,chr15:32698707-32700010
sample_1_Aligned.sortedByCoord.out,chr17,14732194,14735898,+,12,5,17,known,chr17:14732194-14735898
sample_1_Aligned.sortedByCoord.out,chr13,48840973,48848345,+,3,1,4,novel,chr13:48840973-48848345
sample_1_Aligned.sortedByCoord.out,chr2,20882197,20890334,-,10,0,10,known,chr2:20882197-20890334
sample_1_Aligned.sortedByCoord.out,chr4,16552313,16558509,+,8,2,10,known,chr4:16552313-16558509
sample_1_Aligned.sortedByCoord.out,chr4,48622701,48622955,+,7,1,8,known,chr4:48622701-48622955
sample_1_Aligned.sortedByCoord.out,chr9,47997109,48006296,-,12,1,13,novel,chr9:47997109-48006296
sample_1_Aligned.sortedByCoord.out,chr10,14485219,14487234,-,9,3,12,known,chr10:14485219-14487234
sample_1_Aligned.sortedByCoord.out,chr10,10875874,10879942,-,15,0,15,known,chr10:10875874-10879942
sample_1_Aligned.sortedByCoord.out,chr12,6522226,6523332,+,12,1,13,known,chr12:6522226-6523332
sample_1_Aligned.sortedByCoord.out,chr7,1458382,1460597,+,8,4,12,novel,chr7:1458382-1460597
sample_1_Aligned.sortedByCoord.out,chr13,12699723,12704183,-,7,2,9,known,chr13:12699723-12704183
sample_1_Aligned.sortedByCoord.out,chr9,17833987,17836094,+,11,3,14,known,chr9:17833987-17836094
sample_1_Aligned.sortedByCoord.out,chr2,40532281,40539783,-,8,3,11,novel,chr2:40532281-40539783
sample_1_Aligned.sortedByCoord.out,chr8,45455602,45458541,-,11,2,13,known,chr8:45455602-45458541
sample_1_Aligned.sortedByCoord.out,chr1,24911254,24911882,+,8,1,9,known,chr1:24911254-24911882
sample_1_Aligned.sortedByCoord.out,chr11,42958560,42960762,-,13,1,14,known,chr11:42958560-42960762
sample_1_Aligned.sortedByCoord.out,chr2,27444215,27448500,+,4,2,6,known,chr2:27444215-27448500
sample_1_Aligned.sortedByCoord.out,chr8,15010053,15013530,-,8,6,14,known,chr8:15010053-15013530
sample_1_Aligned.sortedByCoord.out,chr8,14606637,14609495,+,12,0,12,known,chr8:14606637-14609495
sample_1_Aligned.sortedByCoord.out,chr4,11109260,11110166,+,7,2,9,known,chr4:11109260-11110166
sample_1_Aligned.sortedByCoord.out,chr17,21623901,21626033,+,6,0,6,known,chr17:21623901-21626033
sample_1_Aligned.sortedByCoord.out,chr22,32377024,32384582,+,12,0,12,novel,chr22:32377024-32384582
sample_1_Aligned.sortedByCoord.out,chr6,23611034,23618919,+,7,2,9,known,chr6:23611034-23618919
sample_1_Aligned.sortedByCoord.out,chr21,24967402,24973690,+,19,2,21,known,chr21:24967402-24973690
sample_1_Aligned.sortedByCoord.out,chr19,14949090,14954341,+,9,1,10,known,chr19:14949090-14954341
sample_1_Aligned.sortedByCoord.out,chr2,5136294,5143265,+,7,2,9,known,chr2:5136294-5143265
sample_1_Aligned.sortedByCoord.out,chr4,49947190,49950339,-,7,0,7,novel,chr4:49947190-49950339
sample_1_Aligned.sortedByCoord.out,chr15,23799559,23802282,-,12,2,14,known,chr15:23799559-23802282
sample_1_Aligned.sortedByCoord.out,chr18,16714923,16724306,+,10,2,12,known,chr18:16714923-16724306
sample_1_Aligned.sortedByCoord.out,chr11,47569544,47571909,-,12,1,13,known,chr11:47569544-47571909
sample_1_Aligned.sortedByCoord.out,chr21,48348139,48356414,+,11,1,12,known,chr21:48348139-48356414
sample_1_Aligned.sortedByCoord.out,chr12,11277906,11279409,+,9,2,11,novel,chr12:11277906-11279409
sample_1_Aligned.sortedByCoord.out,chr21,11599043,11607189,+,12,0,12,known,chr21:11599043-11607189
sample_1_Aligned.sortedByCoord.out,chr5,30698000,30706713,+,11,0,11,novel,chr5:30698000-30706713
sample_1_Aligned.sortedByCoord.out,chr13,24729044,24738454,-,3,2,5,known,chr13:24729044-24738454
sample_1_Aligned.sortedByCoord.out,chr3,38701530,38704463,-,11,2,13,known,chr3:38701530-38704463
sample_1_Aligned.sortedByCoord.out,chr20,28120651,28124575,-,10,2,12,known,chr20:28120651-28124575
sample_1_Aligned.sortedByCoord.out,chr3,35732896,35735848,+,10,2,12,known,chr3:35732896-35735848
sample_1_Aligned.sortedByCoord.out,chr3,18333920,18341020,-,9,2,11,known,chr3:18333920-18341020
sample_1_Aligned.sortedByCoord.out,chr5,26060434,26063893,-,13,0,13,known,chr5:26060434-26063893
sample_1_Aligned.sortedByCoord.out,chr5,13554396,13559881,+,8,3,11,known,chr5:13554396-13559881
sample_1_Aligned.sortedByCoord.out,chr22,19640080,19649871,-,6,2,8,known,chr22:19640080-19649871
sample_1_Aligned.sortedByCoord.out,chr12,10335017,10338036,+,10,5,15,known,chr12:10335017-10338036
sample_1_Aligned.sortedByCoord.out,chr12,22478871,22483812,-,13,0,13,novel,chr12:22478871-22483812
sample_1_Aligned.sortedByCoord.out,chr10,6219310,6223155,-,10,2,12,known,chr10:6219310-6223155
sample_1_Aligned.sortedByCoord.out,chr10,11706835,11709669,-,9,2,11,known,chr10:11706835-11709669
sample_1_Aligned.sortedByCoord.out,chr8,16076096,16079664,-,12,4,16,known,chr8:16076096-16079664
sample_1_Aligned.sortedByCoord.out,chr16,29376545,29382111,-,10,0,10,known,chr16:29376545-29382111
sample_1_Aligned.sortedByCoord.out,chr18,39238777,39239329,-,7,1,8,novel,chr18:39238777-39239329
sample_1_Aligned.sortedByCoord.out,chr4,22195844,22203180,+,12,1,13,novel,chr4:22195844-22203180
sample_1_Aligned.sortedByCoord.out,chr10,46472604,46474473,+,9,2,11,known,chr10:46472604-46474473
sample_1_Aligned.sortedByCoord.out,chr9,10919173,10925180,+,6,1,7,known,chr9:10919173-10925180
sample_1_Aligned.sortedByCoord.out,chr13,36652880,36661606,-,6,0,6,novel,chr13:36652880-36661606
sample_1_Aligned.sortedByCoord.out,chr15,42027623,42031375,+,6,1,7,known,chr15:42027623-42031375
sample_1_Aligned.sortedByCoord.out,chr15,1163146,1163745,-,12,3,15,novel,chr15:1163146-1163745
sample_1_Aligned.sortedByCoord.out,chr6,33353662,33358716,+,10,2,12,known,chr6:33353662-33358716
sample_1_Aligned.sortedByCoord.out,chr15,11148892,11156830,-,6,3,9,known,chr15:11148892-11156830
sample_1_Aligned.sortedByCoord.out,chr7,25154321,25158372,+,9,1,10,novel,chr7:25154321-25158372
sample_1_Aligned.sortedByCoord.out,chr2,43251174,43259088,-,12,4,16,known,chr2:43251174-43259088
sample_1_Aligned.sortedByCoord.out,chr9,28664129,28671054,+,8,3,11,known,chr9:28664129-28671054
sample_1_Aligned.sortedByCoord.out,chr18,12070524,12071626,-,15,2,17,known,chr18:12070524-12071626
sample_1_Aligned.sortedByCoord.out,chr2,22233411,22241627,+,12,1,13,known,chr2:22233411-22241627
sample_1_Aligned.sortedByCoord.out,chr13,32488256,32494831,+,10,2,12,known,chr13:32488256-32494831
sample_1_Aligned.sortedByCoord.out,chr11,12305784,12315164,-,11,1,12,known,chr11:12305784-12315164
sample_1_Aligned.sortedByCoord.out,chr11,43800813,43803847,-,12,3,15,known,chr11:43800813-43803847
sample_1_Aligned.sortedByCoord.out,chr3,17847865,17848820,-,7,0,7,known,chr3:17847865-17848820
sample_1_Aligned.sortedByCoord.out,chr8,36027750,36031049,-,10,0,10,known,chr8:36027750-36031049
sample_1_Aligned.sortedByCoord.out,chr6,4962781,4965801,-,9,3,12,known,chr6:4962781-4965801
sample_1_Aligned.sortedByCoord.out,chr7,13928489,13933813,-,10,2,12,known,chr7:13928489-13933813
sample_1_Aligned.sortedByCoord.out,chr17,13584345,13586458,-,12,6,18,known,chr17:13584345-13586458
sample_1_Aligned.sortedByCoord.out,chr1,25725364,25725824,-,14,4,18,known,chr1:25725364-25725824
sample_1_Aligned.sortedByCoord.out,chr4,28837166,28839540,+,9,2,11,known,chr4:28837166-28839540
sample_1_Aligned.sortedByCoord.out,chr4,24494802,24498786,-,4,4,8,known,chr4:24494802-24498786
sample_1_Aligned.sortedByCoord.out,chr11,36124563,36134528,-,5,1,6,known,chr11:36124563-36134528
sample_1_Aligned.sortedByCoord.out,chr4,3808296,3815956,+,2,0,2,known,chr4:3808296-3815956
sample_1_Aligned.sortedByCoord.out,chr18,20215504,20218236,-,15,2,17,known,chr18:20215504-20218236
sample_1_Aligned.sortedByCoord.out,chr7,34701151,34704382,+,16,1,17,novel,chr7:34701151-34704382
sample_1_Aligned.sortedByCoord.out,chr16,47065382,47070985,-,16,3,19,known,chr16:47065382-47070985
sample_1_Aligned.sortedByCoord.out,chr1,8749607,8757475,+,10,2,12,known,chr1:8749607-8757475
sample_1_Aligned.sortedByCoord.out,chr11,33309491,33318320,+,8,3,11,known,chr11:33309491-33318320
sample_1_Aligned.sortedByCoord.out,chr22,4152521,4160753,+,11,2,13,known,chr22:4152521-4160753
sample_1_Aligned.sortedByCoord.out,chr20,14566144,14566751,-,12,0,12,known,chr20:14566144-14566751
sample_1_Aligned.sortedByCoord.out,chr1,17813817,17815782,+,8,1,9,known,chr1:17813817-17815782
sample_1_Aligned.sortedByCoord.out,chr20,29582940,29585793,-,10,0,10,known,chr20:29582940-29585793
sample_1_Aligned.sortedByCoord.out,chr8,30867689,30875007,-,8,1,9,known,chr8:30867689-30875007
sample_1_Aligned.sortedByCoord.out,chr22,43956587,43964170,+,12,2,14,known,chr22:43956587-43964170
sample_1_Aligned.sortedByCoord.out,chr18,11150592,11156279,+,10,0,10,known,chr18:11150592-11156279
sample_1_Aligned.sortedByCoord.out,chr20,43279194,43282961,-,9,1,10,known,chr20:43279194-43282961
sample_1_Aligned.sortedByCoord.out,chr10,5638196,5640022,-,9,1,10,known,chr10:5638196-5640022
sample_1_Aligned.sortedByCoord.out,chr20,23281773,23291373,+,13,1,14,novel,chr20:23281773-23291373
sample_1_Aligned.sortedByCoord.out,chr20,19688148,19691611,+,12,1,13,known,chr20:19688148-19691611
sample_1_Aligned.sortedByCoord.out,chr12,8470385,8470952,+,6,3,9,known,chr12:8470385-8470952
sample_1_Aligned.sortedByCoord.out,chr18,41208954,41210040,-,4,0,4,known,chr18:41208954-41210040
sample_1_Aligned.sortedByCoord.out,chr21,37255393,37258869,+,11,0,11,known,chr21:37255393-37258869
sample_1_Aligned.sortedByCoord.out,chr20,41610288,41616960,+,6,2,8,novel,chr20:41610288-41616960
sample_1_Aligned.sortedByCoord.out,chr17,20984873,20993096,-,15,1,16,known,chr17:20984873-20993096
sample_1_Aligned.sortedByCoord.out,chr6,6905611,6907505,-,12,0,12,known,chr6:6905611-6907505
sample_1_Aligned.sortedByCoord.out,chr5,14622641,14626398,+,8,4,12,known,chr5:14622641-14626398
sample_1_Aligned.sortedByCoord.out,chr12,20920650,20927742,+,9,1,10,known,chr12:20920650-20927742
sample_1_Aligned.sortedByCoord.out,chr17,43154449,43159824,+,12,0,12,known,chr17:43154449-43159824
sample_1_Aligned.sortedByCoord.out,chr8,43666497,43666801,-,17,1,18,novel,chr8:43666497-43666801
sample_1_Aligned.sortedByCoord.out,chr17,46842824,46843168,-,14,2,16,known,chr17:46842824-46843168
sample_1_Aligned.sortedByCoord.out,chr13,19445428,19452885,-,9,1,10,known,chr13:19445428-19452885
sample_1_Aligned.sortedByCoord.out,chr9,44206581,44215991,-,8,1,9,known,chr9:44206581-44215991
sample_1_Aligned.sortedByCoord.out,chr8,3046641,3054037,-,10,0,10,known,chr8:3046641-3054037
sample_1_Aligned.sortedByCoord.out,chr2,43073262,43074562,+,7,3,10,known,chr2:43073262-43074562
sample_1_Aligned.sortedByCoord.out,chr16,21779378,21788788,-,6,2,8,known,chr16:21779378-21788788
sample_1_Aligned.sortedByCoord.out,chr8,4846691,4848652,+,12,3,15,novel,chr8:4846691-4848652
sample_1_Aligned.sortedByCoord.out,chr16,15487340,15491078,+,6,1,7,known,chr16:15487340-15491078
sample_1_Aligned.sortedByCoord.out,chr14,24344375,24344699,-,10,2,12,known,chr14:24344375-24344699
sample_1_Aligned.sortedByCoord.out,chr5,45387287,45395815,+,10,4,14,known,chr5:45387287-45395815
sample_1_Aligned.sortedByCoord.out,chr13,24203528,24212629,-,11,4,15,known,chr13:24203528-24212629
sample_1_Aligned.sortedByCoord.out,chr5,49838826,49841735,-,10,3,13,known,chr5:49838826-49841735
sample_1_Aligned.sortedByCoord.out,chr6,7342754,7346196,+,11,2,13,known,chr6:7342754-7346196
sample_1_Aligned.sortedByCoord.out,chr3,35076698,35084565,+,13,4,17,known,chr3:35076698-35084565
sample_1_Aligned.sortedByCoord.out,chr12,30144340,30153099,-,11,2,13,known,chr12:30144340-30153099
sample_1_Aligned.sortedByCoord.out,chr16,32234026,32243167,-,8,1,9,novel,chr16:32234026-32243167
sample_1_Aligned.sortedByCoord.out,chr5,17526424,17534056,+,10,0,10,known,chr5:17526424-17534056
sample_1_Aligned.sortedByCoord.out,chr3,8192890,8201669,+,12,3,15,known,chr3:8192890-8201669
sample_1_Aligned.sortedByCoord.out,chr5,17637256,17640375,-,8,1,9,known,chr5:17637256-17640375
sample_1_Aligned.sortedByCoord.out,chr5,6953321,6954051,+,9,5,14,known,chr5:6953321-6954051
sample_1_Aligned.sortedByCoord.out,chr5,39680379,39685890,+,10,2,12,novel,chr5:39680379-39685890
sample_1_Aligned.sortedByCoord.out,chr15,19413946,19420040,+,8,1,9,known,chr15:19413946-19420040
sample_1_Aligned.sortedByCoord.out,chr3,42738774,42745392,-,11,4,15,known,chr3:42738774-42745392
sample_1_Aligned.sortedByCoord.out,chr12,10528785,10533552,-,7,5,12,known,chr12:10528785-10533552
sample_1_Aligned.sortedByCoord.out,chr20,20792911,20795565,-,7,1,8,known,chr20:20792911-20795565
sample_1_Aligned.sortedByCoord.out,chr3,7354088,7361749,-,7,1,8,novel,chr3:7354088-7361749
sample_1_Aligned.sortedByCoord.out,chr8,24817179,24817723,-,6,2,8,known,chr8:24817179-24817723
sample_1_Aligned.sortedByCoord.out,chr4,26399605,26400236,-,5,3,8,known,chr4:26399605-26400236
sample_1_Aligned.sortedByCoord.out,chr16,38208876,38217573,-,13,4,17,known,chr16:38208876-38217573
sample_1_Aligned.sortedByCoord.out,chr17,18287413,18293973,+,16,2,18,known,chr17:18287413-18293973
sample_1_Aligned.sortedByCoord.out,chr10,28561295,28569974,-,4,2,6,known,chr10:28561295-28569974
sample_1_Aligned.sortedByCoord.out,chr1,17501633,17509909,+,10,2,12,known,chr1:17501633-17509909
sample_1_Aligned.sortedByCoord.out,chr9,16164920,16165389,-,13,0,13,known,chr9:16164920-16165389
sample_1_Aligned.sortedByCoord.out,chr18,14940320,14942041,+,6,3,9,known,chr18:14940320-14942041
sample_1_Aligned.sortedByCoord.out,chr4,3627195,3627975,-,16,2,18,known,chr4:3627195-3627975
sample_1_Aligned.sortedByCoord.out,chr4,20452103,20458589,-,7,1,8,known,chr4:20452103-20458589
sample_1_Aligned.sortedByCoord.out,chr21,9346686,9351206,+,5,4,9,known,chr21:9346686-9351206
sample_1_Aligned.sortedByCoord.out,chr6,41232791,41237148,+,13,1,14,known,chr6:41232791-41237148
sample_1_Aligned.sortedByCoord.out,chr10,42530726,42534458,+,11,0,11,known,chr10:42530726-42534458
sample_1_Aligned.sortedByCoord.out,chr16,12192382,12192589,-,8,1,9,known,chr16:12192382-12192589
sample_1_Aligned.sortedByCoord.out,chr14,24399300,24402089,-,8,5,13,known,chr14:24399300-24402089
sample_1_Aligned.sortedByCoord.out,chr10,35127262,35134229,+,16,6,22,novel,chr10:35127262-35134229
sample_1_Aligned.sortedByCoord.out,chr20,20917278,20925389,+,13,1,14,known,chr20:20917278-20925389
sample_1_Aligned.sortedByCoord.out,chr22,1966134,1973293,+,11,1,12,known,chr22:1966134-1973293
sample_1_Aligned.sortedByCoord.out,chr3,5008194,5017087,+,10,1,11,known,chr3:5008194-5017087
sample_1_Aligned.sortedByCoord.out,chr21,32291964,32300531,+,14,3,17,known,chr21:32291964-32300531
sample_1_Aligned.sortedByCoord.out,chr8,27197930,27206322,-,11,3,14,novel,chr8:27197930-27206322
sample_1_Aligned.sortedByCoord.out,chr17,21002492,21002792,+,13,1,14,known,chr17:21002492-21002792
sample_1_Aligned.sortedByCoord.out,chr2,39020399,39028120,-,12,1,13,known,chr2:39020399-39028120
sample_1_Aligned.sortedByCoord.out,chr8,18038492,18042322,-,4,4,8,novel,chr8:18038492-18042322
sample_1_Aligned.sortedByCoord.out,chr5,13920649,13924832,+,12,4,16,novel,chr5:13920649-13924832
sample_1_Aligned.sortedByCoord.out,chr5,37584803,37590951,+,13,1,14,known,chr5:37584803-37590951
sample_1_Aligned.sortedByCoord.out,chr3,25286644,25289296,-,9,3,12,known,chr3:25286644-25289296
sample_1_Aligned.sortedByCoord.out,chr9,45363268,45367807,-,6,0,6,known,chr9:45363268-45367807
sample_1_Aligned.sortedByCoord.out,chr10,34626673,34636322,+,16,2,18,known,chr10:34626673-34636322
sample_1_Aligned.sortedByCoord.out,chr15,38411004,38414017,+,5,2,7,known,chr15:38411004-38414017
sample_1_Aligned.sortedByCoord.out,chr2,26166104,26170320,+,17,0,17,known,chr2:26166104-26170320
sample_1_Aligned.sortedByCoord.out,chr12,11020178,11029341,+,11,2,13,known,chr12:11020178-11029341
sample_1_Aligned.sortedByCoord.out,chr1,13253536,13261080,+,9,2,11,known,chr1:13253536-13261080
sample_1_Aligned.sortedByCoord.out,chr20,17484185,17487361,+,8,1,9,known,chr20:17484185-17487361
sample_1_Aligned.sortedByCoord.out,chr4,25198496,25205976,+,15,2,17,novel,chr4:25198496-25205976
sample_1_Aligned.sortedByCoord.out,chr6,26597973,26605441,-,8,0,8,known,chr6:26597973-26605441
sample_1_Aligned.sortedByCoord.out,chr19,45078639,45086750,-,5,1,6,known,chr19:45078639-45086750
sample_1_Aligned.sortedByCoord.out,chr15,5599427,5603246,+,10,1,11,known,chr15:5599427-5603246
sample_1_Aligned.sortedByCoord.out,chr10,33139343,33147746,-,7,3,10,known,chr10:33139343-33147746
sample_1_Aligned.sortedByCoord.out,chr4,39445462,39448178,+,10,1,11,novel,chr4:39445462-39448178
sample_1_Aligned.sortedByCoord.out,chr22,38716925,38719484,+,7,2,9,known,chr22:38716925-38719484
sample_1_Aligned.sortedByCoord.out,chr16,39571534,39575079,+,12,3,15,known,chr16:39571534-39575079
sample_1_Aligned.sortedByCoord.out,chr17,29061253,29068480,-,16,1,17,novel,chr17:29061253-29068480
sample_1_Aligned.sortedByCoord.out,chr16,23502800,23505188,+,4,1,5,known,chr16:23502800-23505188
sample_1_Aligned.sortedByCoord.out,chr9,40272708,40274093,-,10,1,11,novel,chr9:40272708-40274093
sample_1_Aligned.sortedByCoord.out,chr16,11944921,11953389,+,10,2,12,known,chr16:11944921-11953389
sample_1_Aligned.sortedByCoord.out,chr19,45096638,45100126,+,8,2,10,known,chr19:45096638-45100126
sample_1_Aligned.sortedByCoord.out,chr3,8830961,8840372,-,10,1,11,known,chr3:8830961-8840372
sample_1_Aligned.sortedByCoord.out,chr21,32755104,32762004,-,9,3,12,known,chr21:32755104-32762004
sample_1_Aligned.sortedByCoord.out,chr21,19203363,19207847,-,4,4,8,known,chr21:19203363-19207847
sample_1_Aligned.sortedByCoord.out,chr2,42371963,42380714,+,11,0,11,known,chr2:42371963-42380714
sample_1_Aligned.sortedByCoord.out,chr22,26320723,26322139,-,7,2,9,known,chr22:26320723-26322139
sample_1_Aligned.sortedByCoord.out,chr11,33066229,33072955,+,11,1,12,known,chr11:33066229-33072955
sample_1_Aligned.sortedByCoord.out,chr2,15514748,15524412,+,8,2,10,known,chr2:15514748-15524412
sample_1_Aligned.sortedByCoord.out,chr13,27495493,27497893,-,10,0,10,known,chr13:27495493-27497893
sample_1_Aligned.sortedByCoord.out,chr11,43105806,43109414,-,8,1,9,known,chr11:43105806-43109414
sample_1_Aligned.sortedByCoord.out,chr1,43873009,43882501,-,9,1,10,known,chr1:43873009-43882501
sample_1_Aligned.sortedByCoord.out,chr4,47133027,47140958,-,14,2,16,known,chr4:47133027-47140958
sample_1_Aligned.sortedByCoord.out,chr3,47544527,47548118,-,8,3,11,known,chr3:47544527-47548118
sample_1_Aligned.sortedByCoord.out,chr1,29596553,29603677,-,11,1,12,known,chr1:29596553-29603677
sample_1_Aligned.sortedByCoord.out,chr6,35366912,35367893,-,8,5,13,known,chr6:35366912-35367893
sample_1_Aligned.sortedByCoord.out,chr19,19217603,19223122,+,9,2,11,known,chr19:19217603-19223122
sample_1_Aligned.sortedByCoord.out,chr17,49495281,49496329,+,17,0,17,known,chr17:49495281-49496329
sample_1_Aligned.sortedByCoord.out,chr3,16615732,16620725,+,8,0,8,known,chr3:16615732-16620725
sample_1_Aligned.sortedByCoord.out,chr12,36102845,36103289,-,8,4,12,known,chr12:36102845-36103289
sample_1_Aligned.sortedByCoord.out,chr20,35875359,35878205,-,7,0,7,novel,chr20:35875359-35878205
sample_1_Aligned.sortedByCoord.out,chr9,42888708,42892428,+,6,0,6,known,chr9:42888708-42892428
sample_1_Aligned.sortedByCoord.out,chr3,41050715,41057612,+,19,2,21,known,chr3:41050715-41057612
sample_1_Aligned.sortedByCoord.out,chr16,26371314,26377633,-,15,3,18,known,chr16:26371314-26377633
sample_1_Aligned.sortedByCoord.out,chr21,48764392,48771804,+,8,4,12,known,chr21:48764392-48771804
sample_1_Aligned.sortedByCoord.out,chr12,31840179,31846983,-,14,1,15,known,chr12:31840179-31846983
sample_1_Aligned.sortedByCoord.out,chr13,10294789,10299000,+,13,1,14,known,chr13:10294789-10299000
sample_1_Aligned.sortedByCoord.out,chr5,23900063,23905119,+,9,3,12,known,chr5:23900063-23905119
sample_1_Aligned.sortedByCoord.out,chr22,15298562,15301504,+,4,1,5,known,chr22:15298562-15301504
sample_1_Aligned.sortedByCoord.out,chr16,2743124,2746385,-,10,3,13,novel,chr16:2743124-2746385
sample_1_Aligned.sortedByCoord.out,chr6,36762159,36768037,-,10,2,12,known,chr6:36762159-36768037
sample_1_Aligned.sortedByCoord.out,chr17,28214367,28222860,-,8,4,12,novel,chr17:28214367-28222860
sample_1_Aligned.sortedByCoord.out,chr22,42584755,42585995,-,10,1,11,novel,chr22:42584755-42585995
sample_1_Aligned.sortedByCoord.out,chr20,8631842,8633047,+,11,1,12,known,chr20:8631842-8633047
sample_1_Aligned.sortedByCoord.out,chr16,45180498,45189633,-,12,2,14,known,chr16:45180498-45189633
sample_1_Aligned.sortedByCoord.out,chr19,16997149,17000452,+,5,3,8,known,chr19:16997149-17000452
sample_1_Aligned.sortedByCoord.out,chr15,12309673,12313621,-,11,2,13,novel,chr15:12309673-12313621
sample_1_Aligned.sortedByCoord.out,chr8,44505057,44509735,+,15,2,17,known,chr8:44505057-44509735
sample_1_Aligned.sortedByCoord.out,chr19,44180161,44186304,-,8,0,8,known,chr19:44180161-44186304
sample_1_Aligned.sortedByCoord.out,chr7,36707859,36716424,-,10,2,12,known,chr7:36707859-36716424
sample_1_Aligned.sortedByCoord.out,chr1,45936067,45939368,-,8,2,10,known,chr1:45936067-45939368
sample_1_Aligned.sortedByCoord.out,chr20,37218518,37219166,-,12,2,14,known,chr20:37218518-37219166
sample_1_Aligned.sortedByCoord.out,chr17,49631820,49632363,+,11,1,12,known,chr17:49631820-49632363
sample_1_Aligned.sortedByCoord.out,chr7,13775973,13776560,+,11,3,14,known,chr7:13775973-13776560
sample_1_Aligned.sortedByCoord.out,chr11,29469648,29474359,+,8,2,10,known,chr11:29469648-29474359
sample_1_Aligned.sortedByCoord.out,chr4,43888466,43890526,+,12,0,12,known,chr4:43888466-43890526
sample_1_Aligned.sortedByCoord.out,chr14,7081841,7090447,+,8,1,9,novel,chr14:7081841-7090447
sample_1_Aligned.sortedByCoord.out,chr16,10105669,10112721,+,6,3,9,known,chr16:10105669-10112721
sample_1_Aligned.sortedByCoord.out,chr8,37248528,37257118,+,9,4,13,known,chr8:37248528-37257118
sample_1_Aligned.sortedByCoord.out,chr3,49378195,49382354,+,9,2,11,known,chr3:49378195-49382354
sample_1_Aligned.sortedByCoord.out,chr4,37502917,37509578,-,15,0,15,known,chr4:37502917-37509578
sample_1_Aligned.sortedByCoord.out,chr6,24978846,24988411,-,13,4,17,novel,chr6:24978846-24988411
sample_1_Aligned.sortedByCoord.out,chr5,31891620,31897257,-,6,3,9,known,chr5:31891620-31897257
sample_1_Aligned.sortedByCoord.out,chr6,17146890,17153485,+,7,1,8,known,chr6:17146890-17153485
sample_1_Aligned.sortedByCoord.out,chr8,28651410,28656912,-,17,1,18,known,chr8:28651410-28656912
sample_1_Aligned.sortedByCoord.out,chr5,32206639,32211075,+,15,1,16,novel,chr5:32206639-32211075
sample_1_Aligned.sortedByCoord.out,chr21,33144993,33148857,+,5,3,8,known,chr21:33144993-33148857
sample_1_Aligned.sortedByCoord.out,chr7,45862520,45865345,+,10,3,13,novel,chr7:45862520-45865345
sample_1_Aligned.sortedByCoord.out,chr19,34219291,34220752,-,11,2,13,known,chr19:34219291-34220752
sample_1_Aligned.sortedByCoord.out,chr17,22118448,22128193,-,8,5,13,known,chr17:22118448-22128193
sample_1_Aligned.sortedByCoord.out,chr11,28106320,28112575,-,13,1,14,novel,chr11:28106320-28112575
sample_1_Aligned.sortedByCoord.out,chr1,11561076,11565762,+,13,3,16,known,chr1:11561076-11565762
sample_1_Aligned.sortedByCoord.out,chr16,19104280,19105759,+,13,1,14,known,chr16:19104280-19105759
sample_1_Aligned.sortedByCoord.out,chr8,45694286,45696457,-,9,1,10,known,chr8:45694286-45696457
sample_1_Aligned.sortedByCoord.out,chr20,41844958,41845531,-,14,1,15,known,chr20:41844958-41845531
sample_1_Aligned.sortedByCoord.out,chr7,44205312,44214504,-,9,2,11,known,chr7:44205312-44214504
sample_1_Aligned.sortedByCoord.out,chr9,19753018,19755968,-,15,4,19,known,chr9:19753018-19755968
sample_1_Aligned.sortedByCoord.out,chr9,15480262,15486340,+,10,2,12,known,chr9:15480262-15486340
sample_1_Aligned.sortedByCoord.out,chr10,18065470,18066110,-,13,3,16,known,chr10:18065470-18066110
sample_1_Aligned.sortedByCoord.out,chr9,8379320,8385227,-,14,1,15,novel,chr9:8379320-8385227
sample_1_Aligned.sortedByCoord.out,chr3,2029153,2036716,+,12,4,16,known,chr3:2029153-2036716
sample_1_Aligned.sortedByCoord.out,chr6,45128234,45134311,-,14,3,17,known,chr6:45128234-45134311
sample_1_Aligned.sortedByCoord.out,chr1,31551857,31552348,+,11,0,11,known,chr1:31551857-31552348
sample_1_Aligned.sortedByCoord.out,chr18,44743326,44752219,-,13,2,15,known,chr18:44743326-44752219
sample_1_Aligned.sortedByCoord.out,chr15,10095658,10104201,+,9,4,13,known,chr15:10095658-10104201
sample_1_Aligned.sortedByCoord.out,chr11,42384033,42386560,-,19,0,19,novel,chr11:42384033-42386560
sample_1_Aligned.sortedByCoord.out,chr11,12912971,12914897,-,13,5,18,known,chr11:12912971-12914897
sample_1_Aligned.sortedByCoord.out,chr13,46502625,46504129,+,10,1,11,novel,chr13:46502625-46504129
sample_1_Aligned.sortedByCoord.out,chr8,22249525,22249795,-,7,3,10,known,chr8:22249525-22249795
sample_1_Aligned.sortedByCoord.out,chr2,17025835,17026600,-,11,0,11,novel,chr2:17025835-17026600
sample_1_Aligned.sortedByCoord.out,chr14,38753919,38758818,-,10,4,14,known,chr14:38753919-38758818
sample_1_Aligned.sortedByCoord.out,chr11,17572723,17575918,-,14,1,15,known,chr11:17572723-17575918
sample_1_Aligned.sortedByCoord.out,chr8,36151065,36154172,+,11,1,12,novel,chr8:36151065-36154172
sample_1_Aligned.sortedByCoord.out,chr10,29019459,29027113,+,4,1,5,known,chr10:29019459-29027113
sample_1_Aligned.sortedByCoord.out,chr6,27599409,27601340,-,14,1,15,known,chr6:27599409-27601340
sample_1_Aligned.sortedByCoord.out,chr6,38048559,38050624,+,12,2,14,novel,chr6:38048559-38050624
sample_1_Aligned.sortedByCoord.out,chr20,2106035,2112146,-,11,5,16,novel,chr20:2106035-2112146
sample_1_Aligned.sortedByCoord.out,chr8,12480133,12484839,-,10,3,13,known,chr8:12480133-12484839
sample_1_Aligned.sortedByCoord.out,chr6,20023094,20024310,-,10,1,11,known,chr6:20023094-20024310
sample_1_Aligned.sortedByCoord.out,chr18,25890566,25894158,+,10,3,13,novel,chr18:25890566-25894158
sample_1_Aligned.sortedByCoord.out,chr19,30502811,30504010,-,10,1,11,known,chr19:30502811-30504010
sample_1_Aligned.sortedByCoord.out,chr19,8784243,8785575,-,5,4,9,known,chr19:8784243-8785575
sample_1_Aligned.sortedByCoord.out,chr16,11139479,11141640,-,12,1,13,known,chr16:11139479-11141640
sample_1_Aligned.sortedByCoord.out,chr6,26355672,26357199,+,14,0,14,known,chr6:26355672-26357199
sample_1_Aligned.sortedByCoord.out,chr16,4107300,4115400,-,6,3,9,novel,chr16:4107300-4115400
sample_1_Aligned.sortedByCoord.out,chr2,48729249,48739221,+,7,4,11,known,chr2:48729249-48739221
sample_1_Aligned.sortedByCoord.out,chr4,34066313,34073061,+,8,2,10,known,chr4:34066313-34073061
sample_1_Aligned.sortedByCoord.out,chr7,30856285,30866169,-,9,4,13,known,chr7:30856285-30866169
sample_1_Aligned.sortedByCoord.out,chr14,9888786,9892166,+,11,0,11,known,chr14:9888786-9892166
sample_1_Aligned.sortedByCoord.out,chr17,3797749,3799032,-,16,2,18,known,chr17:3797749-3799032
sample_1_Aligned.sortedByCoord.out,chr2,2333661,2334180,-,10,3,13,known,chr2:2333661-2334180
sample_1_Aligned.sortedByCoord.out,chr21,5160357,5162030,-,11,0,11,known,chr21:5160357-5162030
sample_1_Aligned.sortedByCoord.out,chr7,28158480,28165332,-,16,1,17,novel,chr7:28158480-28165332
sample_1_Aligned.sortedByCoord.out,chr5,46653830,46655845,+,13,1,14,known,chr5:46653830-46655845
sample_1_Aligned.sortedByCoord.out,chr1,18914414,18917815,-,9,1,10,known,chr1:18914414-18917815
sample_1_Aligned.sortedByCoord.out,chr5,34907369,34916290,-,12,2,14,known,chr5:34907369-34916290
sample_1_Aligned.sortedByCoord.out,chr18,13154244,13159079,+,7,2,9,known,chr18:13154244-13159079
sample_1_Aligned.sortedByCoord.out,chr4,37324569,37328509,-,14,2,16,known,chr4:37324569-37328509
sample_1_Aligned.sortedByCoord.out,chr3,45907446,45907548,+,11,4,15,novel,chr3:45907446-45907548
sample_1_Aligned.sortedByCoord.out,chr2,39220527,39223430,-,7,1,8,known,chr2:39220527-39223430
sample_1_Aligned.sortedByCoord.out,chr20,49419881,49428206,-,6,1,7,known,chr20:49419881-49428206
sample_1_Aligned.sortedByCoord.out,chr8,19479039,19484391,-,11,1,12,known,chr8:19479039-19484391
sample_1_Aligned.sortedByCoord.out,chr9,18190074,18194471,+,11,2,13,known,chr9:18190074-18194471
sample_1_Aligned.sortedByCoord.out,chr13,13730961,13735600,+,18,3,21,known,chr13:13730961-13735600
sample_1_Aligned.sortedByCoord.out,chr8,1636954,1637555,+,8,2,10,known,chr8:1636954-1637555
sample_1_Aligned.sortedByCoord.out,chr10,32698740,32703137,+,13,4,17,known,chr10:32698740-32703137
sample_1_Aligned.sortedByCoord.out,chr10,10604896,10611912,+,10,3,13,known,chr10:10604896-10611912
sample_1_Aligned.sortedByCoord.out,chr8,45048959,45049928,+,10,2,12,known,chr8:45048959-45049928
sample_1_Aligned.sortedByCoord.out,chr20,13967609,13971547,-,6,2,8,novel,chr20:13967609-13971547
sample_1_Aligned.sortedByCoord.out,chr2,10061139,10062011,+,11,2,13,known,chr2:10061139-10062011
sample_1_Aligned.sortedByCoord.out,chr5,2209240,2219032,-,13,3,16,known,chr5:2209240-2219032
sample_2_Aligned.sortedByCoord.out,chr17,3183200,3190272,+,7,2,9,known,chr17:3183200-3190272
sample_2_Aligned.sortedByCoord.out,chr3,22265732,22275724,-,4,2,6,known,chr3:22265732-22275724
sample_2_Aligned.sortedByCoord.out,chr18,40928838,40930768,-,17,4,21,known,chr18:40928838-40930768
sample_2_Aligned.sortedByCoord.out,chr4,18955070,18963050,-,11,0,11,known,chr4:18955070-18963050
sample_2_Aligned.sortedByCoord.out,chr15,19309629,19313297,-,10,1,11,known,chr15:19309629-19313297
sample_2_Aligned.sortedByCoord.out,chr9,5634267,5640499,-,7,2,9,known,chr9:5634267-5640499
sample_2_Aligned.sortedByCoord.out,chr14,7525886,7532080,+,13,2,15,known,chr14:7525886-7532080
sample_2_Aligned.sortedByCoord.out,chr19,41671541,41678546,-,10,1,11,novel,chr19:41671541-41678546
sample_2_Aligned.sortedByCoord.out,chr16,15618224,15618702,+,9,0,9,known,chr16:15618224-15618702
sample_2_Aligned.sortedByCoord.out,chr7,16451555,16456524,+,12,3,15,known,chr7:16451555-16456524
sample_2_Aligned.sortedByCoord.out,chr2,39288696,39289077,-,12,1,13,known,chr2:39288696-39289077
sample_2_Aligned.sortedByCoord.out,chr10,41288619,41296104,+,9,4,13,known,chr10:41288619-41296104
sample_2_Aligned.sortedByCoord.out,chr7,26779179,26786583,-,8,2,10,known,chr7:26779179-26786583
sample_2_Aligned.sortedByCoord.out,chr13,35408778,35416275,-,11,1,12,known,chr13:35408778-35416275
sample_2_Aligned.sortedByCoord.out,chr16,49832732,49840557,-,9,1,10,known,chr16:49832732-49840557
sample_2_Aligned.sortedByCoord.out,chr2,38543555,38544296,+,8,0,8,known,chr2:38543555-38544296
sample_2_Aligned.sortedByCoord.out,chr16,9454134,9457688,-,12,6,18,known,chr16:9454134-9457688
sample_2_Aligned.sortedByCoord.out,chr15,3794045,3799369,+,11,3,14,known,chr15:3794045-3799369
sample_2_Aligned.sortedByCoord.out,chr20,15115839,15116101,-,9,4,13,known,chr20:15115839-15116101
sample_2_Aligned.sortedByCoord.out,chr9,46553679,46562024,-,12,2,14,novel,chr9:46553679-46562024
sample_2_Aligned.sortedByCoord.out,chr16,14414997,14415405,+,16,1,17,known,chr16:14414997-14415405
sample_2_Aligned.sortedByCoord.out,chr7,20672850,20674048,+,9,1,10,known,chr7:20672850-20674048
sample_2_Aligned.sortedByCoord.out,chr20,16350912,16359792,-,7,4,11,known,chr20:16350912-16359792
sample_2_Aligned.sortedByCoord.out,chr6,34377794,34383005,-,8,2,10,known,chr6:34377794-34383005
sample_2_Aligned.sortedByCoord.out,chr17,9964031,9972854,+,13,3,16,known,chr17:9964031-9972854
sample_2_Aligned.sortedByCoord.out,chr17,15153800,15159167,-,9,3,12,known,chr17:15153800-15159167
sample_2_Aligned.sortedByCoord.out,chr2,8495027,8504494,-,17,4,21,known,chr2:8495027-8504494
sample_2_Aligned.sortedByCoord.out,chr9,48458897,48467120,-,12,0,12,known,chr9:48458897-48467120
sample_2_Aligned.sortedByCoord.out,chr10,16492978,16493247,+,7,2,9,known,chr10:16492978-16493247
sample_2_Aligned.sortedByCoord.out,chr11,2751172,2757036,+,11,1,12,known,chr11:2751172-2757036
sample_2_Aligned.sortedByCoord.out,chr11,48434459,48442571,+,6,2,8,known,chr11:48434459-48442571
sample_2_Aligned.sortedByCoord.out,chr8,30888569,30891264,+,11,1,12,known,chr8:30888569-30891264
sample_2_Aligned.sortedByCoord.out,chr7,15749548,15752241,+,11,1,12,known,chr7:15749548-15752241
sample_2_Aligned.sortedByCoord.out,chr22,14319292,14319501,-,10,1,11,known,chr22:14319292-14319501
sample_2_Aligned.sortedByCoord.out,chr19,31804380,31813662,-,8,2,10,known,chr19:31804380-31813662
sample_2_Aligned.sortedByCoord.out,chr12,5760534,5764260,+,10,2,12,known,chr12:5760534-5764260
sample_2_Aligned.sortedByCoord.out,chr13,30815449,30816474,-,7,4,11,known,chr13:30815449-30816474
sample_2_Aligned.sortedByCoord.out,chr21,1775522,1783579,+,9,1,10,known,chr21:1775522-1783579
sample_2_Aligned.sortedByCoord.out,chr22,7559288,7562794,+,12,4,16,known,chr22:7559288-7562794
sample_2_Aligned.sortedByCoord.out,chr9,3862541,3871537,-,8,0,8,novel,chr9:3862541-3871537
sample_2_Aligned.sortedByCoord.out,chr22,14241297,14246681,-,9,0,9,novel,chr22:14241297-14246681
sample_2_Aligned.sortedByCoord.out,chr16,28501880,28504916,-,10,0,10,known,chr16:28501880-28504916
sample_2_Aligned.sortedByCoord.out,chr15,34573522,34574351,-,8,1,9,known,chr15:34573522-34574351
sample_2_Aligned.sortedByCoord.out,chr13,21582438,21591320,-,9,1,10,known,chr13:21582438-21591320
sample_2_Aligned.sortedByCoord.out,chr11,18740372,18746256,-,8,1,9,known,chr11:18740372-18746256
sample_2_Aligned.sortedByCoord.out,chr1,24059280,24060784,-,5,1,6,novel,chr1:24059280-24060784
sample_2_Aligned.sortedByCoord.out,chr11,35917051,35922749,-,9,2,11,novel,chr11:35917051-35922749
sample_2_Aligned.sortedByCoord.out,chr16,43960243,43964784,-,9,2,11,known,chr16:43960243-43964784
sample_2_Aligned.sortedByCoord.out,chr20,46904061,46909652,-,9,4,13,known,chr20:46904061-46909652
sample_2_Aligned.sortedByCoord.out,chr14,9687540,9697027,+,13,1,14,known,chr14:9687540-9697027
sample_2_Aligned.sortedByCoord.out,chr9,2888372,2891021,-,13,2,15,known,chr9:2888372-2891021
sample_2_Aligned.sortedByCoord.out,chr5,7665064,7667772,-,11,1,12,known,chr5:7665064-7667772
sample_2_Aligned.sortedByCoord.out,chr9,6000172,6009168,+,13,5,18,known,chr9:6000172-6009168
sample_2_Aligned.sortedByCoord.out,chr11,10438065,10438940,-,20,1,21,novel,chr11:10438065-10438940
sample_2_Aligned.sortedByCoord.out,chr9,1237598,1241059,+,22,2,24,known,chr9:1237598-1241059
sample_2_Aligned.sortedByCoord.out,chr21,16049233,16053052,+,7,2,9,known,chr21:16049233-16053052
sample_2_Aligned.sortedByCoord.out,chr3,27421469,27429681,+,12,2,14,known,chr3:27421469-27429681
sample_2_Aligned.sortedByCoord.out,chr6,48664875,48673304,-,12,1,13,novel,chr6:48664875-48673304
sample_2_Aligned.sortedByCoord.out,chr2,14385450,14391775,+,9,2,11,novel,chr2:14385450-14391775
sample_2_Aligned.sortedByCoord.out,chr16,12183959,12190489,-,9,0,9,novel,chr16:12183959-12190489
sample_2_Aligned.sortedByCoord.out,chr12,13386514,13393316,-,12,0,12,known,chr12:13386514-13393316
sample_2_Aligned.sortedByCoord.out,chr4,20089431,20092354,-,16,2,18,novel,chr4:20089431-20092354
sample_2_Aligned.sortedByCoord.out,chr20,13238642,13241915,-,6,0,6,novel,chr20:13238642-13241915
sample_2_Aligned.sortedByCoord.out,chr22,18997145,19005434,+,9,3,12,known,chr22:18997145-19005434
sample_2_Aligned.sortedByCoord.out,chr10,33908958,33915709,+,10,0,10,novel,chr10:33908958-33915709
sample_2_Aligned.sortedByCoord.out,chr1,19249726,19254219,-,7,2,9,known,chr1:19249726-19254219
sample_2_Aligned.sortedByCoord.out,chr4,30714072,30716404,-,7,2,9,known,chr4:30714072-30716404
sample_2_Aligned.sortedByCoord.out,chr2,29291305,29292374,-,11,4,15,novel,chr2:29291305-29292374
sample_2_Aligned.sortedByCoord.out,chr18,47066100,47075151,-,13,3,16,known,chr18:47066100-47075151
sample_2_Aligned.sortedByCoord.out,chr6,17202375,17204712,+,13,1,14,known,chr6:17202375-17204712
sample_2_Aligned.sortedByCoord.out,chr8,49321491,49323366,+,9,2,11,known,chr8:49321491-49323366
sample_2_Aligned.sortedByCoord.out,chr7,41120757,41128496,-,16,1,17,novel,chr7:41120757-41128496
sample_2_Aligned.sortedByCoord.out,chr16,8491481,8500068,+,14,3,17,known,chr16:8491481-8500068
sample_2_Aligned.sortedByCoord.out,chr5,47274614,47279457,+,11,0,11,known,chr5:47274614-47279457
sample_2_Aligned.sortedByCoord.out,chr22,29223626,29228016,-,11,2,13,known,chr22:29223626-29228016
sample_2_Aligned.sortedByCoord.out,chr20,12909497,12915320,-,12,1,13,known,chr20:12909497-12915320
sample_2_Aligned.sortedByCoord.out,chr18,4638945,4639741,+,14,1,15,novel,chr18:4638945-4639741
sample_2_Aligned.sortedByCoord.out,chr10,43562805,43571984,+,5,1,6,novel,chr10:43562805-43571984
sample_2_Aligned.sortedByCoord.out,chr15,35516569,35519657,+,9,1,10,known,chr15:35516569-35519657
sample_2_Aligned.sortedByCoord.out,chr5,11059576,11067306,-,6,0,6,known,chr5:11059576-11067306
sample_2_Aligned.sortedByCoord.out,chr15,48825648,48831361,+,8,0,8,known,chr15:48825648-48831361
sample_2_Aligned.sortedByCoord.out,chr19,49456645,49458756,-,9,1,10,known,chr19:49456645-49458756
sample_2_Aligned.sortedByCoord.out,chr5,5665178,5666755,+,6,1,7,known,chr5:5665178-5666755
sample_2_Aligned.sortedByCoord.out,chr2,32482201,32486762,-,8,1,9,known,chr2:32482201-32486762
sample_2_Aligned.sortedByCoord.out,chr7,49175318,49179969,+,15,3,18,known,chr7:49175318-49179969
sample_2_Aligned.sortedByCoord.out,chr8,23548979,23558792,+,13,1,14,known,chr8:23548979-23558792
sample_2_Aligned.sortedByCoord.out,chr22,33630463,33634614,-,8,0,8,known,chr22:33630463-33634614
sample_2_Aligned.sortedByCoord.out,chr11,4387516,4396894,-,12,2,14,known,chr11:4387516-4396894
sample_2_Aligned.sortedByCoord.out,chr17,36806336,36812077,+,6,2,8,known,chr17:36806336-36812077
sample_2_Aligned.sortedByCoord.out,chr11,44593261,44602665,+,15,0,15,known,chr11:44593261-44602665
sample_2_Aligned.sortedByCoord.out,chr19,49546179,49552127,-,13,1,14,novel,chr19:49546179-49552127
sample_2_Aligned.sortedByCoord.out,chr17,1219421,1226419,+,7,2,9,novel,chr17:1219421-1226419
sample_2_Aligned.sortedByCoord.out,chr7,21444614,21448716,+,10,1,11,known,chr7:21444614-21448716
sample_2_Aligned.sortedByCoord.out,chr2,25302129,25304585,-,10,6,16,known,chr2:25302129-25304585
sample_2_Aligned.sortedByCoord.out,chr20,29733560,29733721,-,9,2,11,known,chr20:29733560-29733721
sample_2_Aligned.sortedByCoord.out,chr1,19337658,19346298,-,15,4,19,known,chr1:19337658-19346298
sample_2_Aligned.sortedByCoord.out,chr12,38006174,38011881,-,11,4,15,novel,chr12:38006174-38011881
sample_2_Aligned.sortedByCoord.out,chr2,24686945,24692912,+,13,2,15,known,chr2:24686945-24692912
sample_2_Aligned.sortedByCoord.out,chr14,28815803,28823734,+,12,3,15,known,chr14:28815803-28823734
sample_2_Aligned.sortedByCoord.out,chr12,23447982,23449618,-,18,1,19,known,chr12:23447982-23449618
sample_2_Aligned.sortedByCoord.out,chr6,3053927,3062109,-,10,1,11,known,chr6:3053927-3062109
sample_2_Aligned.sortedByCoord.out,chr6,24312529,24320082,+,13,6,19,known,chr6:24312529-24320082
sample_2_Aligned.sortedByCoord.out,chr18,7799589,7800462,-,10,1,11,novel,chr18:7799589-7800462
sample_2_Aligned.sortedByCoord.out,chr1,49047116,49053934,-,8,4,12,known,chr1:49047116-49053934
sample_2_Aligned.sortedByCoord.out,chr6,23712843,23715808,+,10,2,12,known,chr6:23712843-23715808
sample_2_Aligned.sortedByCoord.out,chr11,21950254,21953734,+,9,1,10,known,chr11:21950254-21953734
sample_2_Aligned.sortedByCoord.out,chr20,27620910,27622430,+,12,1,13,novel,chr20:27620910-27622430
sample_2_Aligned.sortedByCoord.out,chr22,33697297,33701740,+,4,0,4,known,chr22:33697297-33701740
sample_2_Aligned.sortedByCoord.out,chr10,29289816,29297496,+,9,2,11,known,chr10:29289816-29297496
sample_2_Aligned.sortedByCoord.out,chr1,6907418,6915308,+,6,1,7,novel,chr1:6907418-6915308
sample_2_Aligned.sortedByCoord.out,chr17,25595250,25597738,+,9,2,11,known,chr17:25595250-25597738
sample_2_Aligned.sortedByCoord.out,chr9,8172398,8172838,-,13,1,14,novel,chr9:8172398-8172838
sample_2_Aligned.sortedByCoord.out,chr11,27982929,27992138,-,5,1,6,known,chr11:27982929-27992138
sample_2_Aligned.sortedByCoord.out,chr4,15319274,15319987,-,15,2,17,known,chr4:15319274-15319987
sample_2_Aligned.sortedByCoord.out,chr11,23811040,23812155,+,11,1,12,known,chr11:23811040-23812155
sample_2_Aligned.sortedByCoord.out,chr20,36635499,36641526,+,10,1,11,known,chr20:36635499-36641526
sample_2_Aligned.sortedByCoord.out,chr20,22846447,22855519,+,13,3,16,known,chr20:22846447-22855519
sample_2_Aligned.sortedByCoord.out,chr8,38426619,38431088,-,13,3,16,novel,chr8:38426619-38431088
sample_2_Aligned.sortedByCoord.out,chr12,35499306,35504845,-,6,3,9,novel,chr12:35499306-35504845
sample_2_Aligned.sortedByCoord.out,chr20,11845207,11852768,-,4,4,8,known,chr20:11845207-11852768
sample_2_Aligned.sortedByCoord.out,chr13,37913536,37921306,+,10,0,10,known,chr13:37913536-37921306
sample_2_Aligned.sortedByCoord.out,chr19,7098470,7098800,+,7,0,7,known,chr19:7098470-7098800
sample_2_Aligned.sortedByCoord.out,chr20,5079671,5085867,-,10,3,13,known,chr20:5079671-5085867
sample_2_Aligned.sortedByCoord.out,chr5,44585195,44591397,-,5,2,7,known,chr5:44585195-44591397
sample_2_Aligned.sortedByCoord.out,chr13,30411123,30420160,+,14,0,14,known,chr13:30411123-30420160
sample_2_Aligned.sortedByCoord.out,chr19,31793630,31798291,+,8,2,10,novel,chr19:31793630-31798291
sample_2_Aligned.sortedByCoord.out,chr2,9268038,9276898,-,4,1,5,novel,chr2:9268038-9276898
sample_2_Aligned.sortedByCoord.out,chr10,5077329,5079815,+,12,1,13,known,chr10:5077329-5079815
sample_2_Aligned.sortedByCoord.out,chr19,1733439,1743352,+,9,1,10,known,chr19:1733439-1743352
sample_2_Aligned.sortedByCoord.out,chr9,25350322,25360071,-,10,7,17,known,chr9:25350322-25360071
sample_2_Aligned.sortedByCoord.out,chr15,10768919,10777401,+,11,1,12,known,chr15:10768919-10777401
sample_2_Aligned.sortedByCoord.out,chr18,46731351,46734799,+,8,3,11,known,chr18:46731351-46734799
sample_2_Aligned.sortedByCoord.out,chr7,41144496,41145808,+,9,0,9,known,chr7:41144496-41145808
sample_2_Aligned.sortedByCoord.out,chr4,6461919,6471515,-,13,2,15,known,chr4:6461919-6471515
sample_2_Aligned.sortedByCoord.out,chr5,38262156,38269820,-,7,4,11,novel,chr5:38262156-38269820
sample_2_Aligned.sortedByCoord.out,chr19,29969691,29972833,-,8,4,12,novel,chr19:29969691-29972833
sample_2_Aligned.sortedByCoord.out,chr20,27716033,27720983,-,13,4,17,known,chr20:27716033-27720983
sample_2_Aligned.sortedByCoord.out,chr4,2142085,2148864,+,11,1,12,known,chr4:2142085-2148864
sample_2_Aligned.sortedByCoord.out,chr18,22847758,22853639,-,8,2,10,known,chr18:22847758-22853639
sample_2_Aligned.sortedByCoord.out,chr1,37011787,37016311,-,9,2,11,known,chr1:37011787-37016311
sample_2_Aligned.sortedByCoord.out,chr6,45526505,45530169,-,11,1,12,known,chr6:45526505-45530169
sample_2_Aligned.sortedByCoord.out,chr16,3810247,3810796,-,7,3,10,novel,chr16:3810247-3810796
sample_2_Aligned.sortedByCoord.out,chr17,2097355,2098032,-,12,2,14,known,chr17:2097355-2098032
sample_2_Aligned.sortedByCoord.out,chr4,16045382,16047574,-,12,3,15,known,chr4:16045382-16047574
sample_2_Aligned.sortedByCoord.out,chr9,2057067,2057401,+,6,1,7,known,chr9:2057067-2057401
sample_2_Aligned.sortedByCoord.out,chr5,38661089,38663609,+,9,2,11,known,chr5:38661089-38663609
sample_2_Aligned.sortedByCoord.out,chr5,26327265,26335382,-,10,1,11,known,chr5:26327265-26335382
sample_2_Aligned.sortedByCoord.out,chr1,46179838,46182995,-,8,0,8,known,chr1:46179838-46182995
sample_2_Aligned.sortedByCoord.out,chr21,36376791,36377202,+,18,3,21,known,chr21:36376791-36377202
sample_2_Aligned.sortedByCoord.out,chr20,29678995,29682891,-,7,2,9,known,chr20:29678995-29682891
sample_2_Aligned.sortedByCoord.out,chr16,30236294,30236608,-,9,2,11,known,chr16:30236294-30236608
sample_2_Aligned.sortedByCoord.out,chr7,32680085,32682094,+,10,1,11,novel,chr7:32680085-32682094
sample_2_Aligned.sortedByCoord.out,chr8,6412706,6414833,-,5,3,8,known,chr8:6412706-6414833
sample_2_Aligned.sortedByCoord.out,chr1,30003647,30008765,+,17,2,19,known,chr1:30003647-30008765
sample_2_Aligned.sortedByCoord.out,chr5,42325369,42331501,+,10,1,11,known,chr5:42325369-42331501
sample_2_Aligned.sortedByCoord.out,chr17,6428984,6436045,-,9,4,13,known,chr17:6428984-6436045
sample_2_Aligned.sortedByCoord.out,chr1,49044169,49052300,+,10,4,14,known,chr1:49044169-49052300
sample_2_Aligned.sortedByCoord.out,chr6,3586697,3595590,+,10,2,12,known,chr6:3586697-3595590
sample_2_Aligned.sortedByCoord.out,chr11,28140686,28143602,-,12,2,14,novel,chr11:28140686-28143602
sample_2_Aligned.sortedByCoord.out,chr1,12558396,12561244,-,11,0,11,novel,chr1:12558396-12561244
sample_2_Aligned.sortedByCoord.out,chr5,24940975,24943904,-,12,2,14,known,chr5:24940975-24943904
sample_2_Aligned.sortedByCoord.out,chr12,13634273,13641530,-,8,1,9,known,chr12:13634273-13641530
sample_2_Aligned.sortedByCoord.out,chr14,30158322,30162910,-,13,3,16,known,chr14:30158322-30162910
sample_2_Aligned.sortedByCoord.out,chr2,44244084,44248535,+,10,2,12,known,chr2:44244084-44248535
sample_2_Aligned.sortedByCoord.out,chr15,3828972,3833192,+,10,3,13,known,chr15:3828972-3833192
sample_2_Aligned.sortedByCoord.out,chr19,44349609,44350502,+,15,1,16,known,chr19:44349609-44350502
sample_2_Aligned.sortedByCoord.out,chr21,40423618,40431756,-,1,1,2,known,chr21:40423618-40431756
sample_2_Aligned.sortedByCoord.out,chr13,6436897,6442179,+,12,4,16,known,chr13:6436897-6442179
sample_2_Aligned.sortedByCoord.out,chr9,32816330,32819972,-,11,2,13,novel,chr9:32816330-32819972
sample_2_Aligned.sortedByCoord.out,chr6,34544885,34548024,-,14,1,15,known,chr6:34544885-34548024
sample_2_Aligned.sortedByCoord.out,chr13,9694360,9699191,-,15,0,15,novel,chr13:9694360-9699191
sample_2_Aligned.sortedByCoord.out,chr11,11615626,11624703,+,9,0,9,known,chr11:11615626-11624703
sample_2_Aligned.sortedByCoord.out,chr3,23709477,23711765,-,5,3,8,known,chr3:23709477-23711765
sample_2_Aligned.sortedByCoord.out,chr2,38280559,38289564,-,11,1,12,known,chr2:38280559-38289564
sample_2_Aligned.sortedByCoord.out,chr1,27855249,27859982,-,10,1,11,known,chr1:27855249-27859982
sample_2_Aligned.sortedByCoord.out,chr1,7641809,7644889,-,15,0,15,known,chr1:7641809-7644889
sample_2_Aligned.sortedByCoord.out,chr19,27022041,27028252,+,9,3,12,known,chr19:27022041-27028252
sample_2_Aligned.sortedByCoord.out,chr17,1849935,1853664,-,7,2,9,novel,chr17:1849935-1853664
sample_2_Aligned.sortedByCoord.out,chr11,32278428,32287038,+,7,0,7,known,chr11:32278428-32287038
sample_2_Aligned.sortedByCoord.out,chr9,33938439,33940680,-,9,0,9,known,chr9:33938439-33940680
sample_2_Aligned.sortedByCoord.out,chr8,13272495,13273056,+,9,3,12,novel,chr8:13272495-13273056
sample_2_Aligned.sortedByCoord.out,chr21,23563063,23570493,+,8,1,9,known,chr21:23563063-23570493
sample_2_Aligned.sortedByCoord.out,chr20,10408797,10412301,-,12,2,14,known,chr20:10408797-10412301
sample_2_Aligned.sortedByCoord.out,chr2,12508352,12511085,-,11,3,14,known,chr2:12508352-12511085
sample_2_Aligned.sortedByCoord.out,chr19,40003294,40011672,+,8,3,11,known,chr19:40003294-40011672
sample_2_Aligned.sortedByCoord.out,chr20,22235909,22243500,-,11,2,13,known,chr20:22235909-22243500
sample_2_Aligned.sortedByCoord.out,chr19,4172720,4178649,-,13,2,15,novel,chr19:4172720-4178649
sample_2_Aligned.sortedByCoord.out,chr21,31315811,31319934,-,10,3,13,novel,chr21:31315811-31319934
sample_2_Aligned.sortedByCoord.out,chr3,20269189,20270626,+,5,1,6,novel,chr3:20269189-20270626
sample_2_Aligned.sortedByCoord.out,chr19,14373065,14374634,-,10,0,10,known,chr19:14373065-14374634
sample_2_Aligned.sortedByCoord.out,chr3,7738287,7747332,+,14,1,15,known,chr3:7738287-7747332
sample_2_Aligned.sortedByCoord.out,chr14,49289802,49291965,-,10,0,10,known,chr14:49289802-49291965
sample_2_Aligned.sortedByCoord.out,chr2,31490594,31491216,+,5,3,8,known,chr2:31490594-31491216
sample_2_Aligned.sortedByCoord.out,chr10,29042059,29049935,-,5,3,8,known,chr10:29042059-29049935
sample_2_Aligned.sortedByCoord.out,chr7,41548488,41554230,+,4,1,5,known,chr7:41548488-41554230
sample_2_Aligned.sortedByCoord.out,chr21,41686168,41694667,-,10,1,11,known,chr21:41686168-41694667
sample_2_Aligned.sortedByCoord.out,chr9,45459386,45467162,+,8,2,10,known,chr9:45459386-45467162
sample_2_Aligned.sortedByCoord.out,chr8,13384748,13392388,+,10,1,11,novel,chr8:13384748-13392388
sample_2_Aligned.sortedByCoord.out,chr10,6365641,6366569,+,8,1,9,known,chr10:6365641-6366569
sample_2_Aligned.sortedByCoord.out,chr17,10731010,10731589,+,10,0,10,known,chr17:10731010-10731589
sample_2_Aligned.sortedByCoord.out,chr9,47069743,47074646,+,11,0,11,novel,chr9:47069743-47074646
sample_2_Aligned.sortedByCoord.out,chr17,36391515,36396535,+,11,3,14,known,chr17:36391515-36396535
sample_2_Aligned.sortedByCoord.out,chr15,37901998,37904816,-,13,4,17,known,chr15:37901998-37904816
sample_2_Aligned.sortedByCoord.out,chr20,36917784,36923412,-,9,1,10,known,chr20:36917784-36923412
sample_2_Aligned.sortedByCoord.out,chr7,24742181,24747236,-,6,0,6,known,chr7:24742181-24747236
sample_2_Aligned.sortedByCoord.out,chr6,15924332,15926493,+,8,3,11,known,chr6:15924332-15926493
sample_2_Aligned.sortedByCoord.out,chr19,17976992,17982448,-,6,4,10,known,chr19:17976992-17982448
sample_2_Aligned.sortedByCoord.out,chr2,43984307,43986120,-,12,3,15,novel,chr2:43984307-43986120
sample_2_Aligned.sortedByCoord.out,chr4,28843440,28849466,+,11,2,13,known,chr4:28843440-28849466
sample_2_Aligned.sortedByCoord.out,chr11,36298540,36306830,+,13,2,15,known,chr11:36298540-36306830
sample_2_Aligned.sortedByCoord.out,chr19,29790658,29792088,+,8,1,9,known,chr19:29790658-29792088
sample_2_Aligned.sortedByCoord.out,chr19,2936813,2945344,-,11,3,14,novel,chr19:2936813-2945344
sample_2_Aligned.sortedByCoord.out,chr19,32136752,32139096,+,10,1,11,novel,chr19:32136752-32139096
sample_2_Aligned.sortedByCoord.out,chr22,38273525,38274333,+,8,2,10,novel,chr22:38273525-38274333
sample_2_Aligned.sortedByCoord.out,chr16,10992356,11000561,-,9,2,11,known,chr16:10992356-11000561
sample_2_Aligned.sortedByCoord.out,chr18,43195266,43204264,-,8,2,10,known,chr18:43195266-43204264
sample_2_Aligned.sortedByCoord.out,chr9,17821844,17825107,-,13,5,18,known,chr9:17821844-17825107
sample_2_Aligned.sortedByCoord.out,chr9,25773737,25779816,-,9,1,10,novel,chr9:25773737-25779816
sample_2_Aligned.sortedByCoord.out,chr5,19006223,19013673,+,8,1,9,known,chr5:19006223-19013673
sample_2_Aligned.sortedByCoord.out,chr3,8911936,8915395,-,7,1,8,known,chr3:8911936-8915395
sample_2_Aligned.sortedByCoord.out,chr3,1366732,1376114,+,10,1,11,novel,chr3:1366732-1376114
sample_2_Aligned.sortedByCoord.out,chr4,44752418,44752599,+,10,2,12,known,chr4:44752418-44752599
sample_2_Aligned.sortedByCoord.out,chr20,26242074,26246492,+,9,1,10,novel,chr20:26242074-26246492
sample_2_Aligned.sortedByCoord.out,chr1,15671496,15678453,+,10,3,13,known,chr1:15671496-15678453
sample_2_Aligned.sortedByCoord.out,chr15,20741713,20749380,+,9,1,10,novel,chr15:20741713-20749380
sample_2_Aligned.sortedByCoord.out,chr14,19613154,19622960,-,11,3,14,known,chr14:19613154-19622960
sample_2_Aligned.sortedByCoord.out,chr15,7543451,7550209,+,12,2,14,known,chr15:7543451-7550209
sample_2_Aligned.sortedByCoord.out,chr15,1295531,1303532,+,11,1,12,novel,chr15:1295531-1303532
sample_2_Aligned.sortedByCoord.out,chr10,11498469,11498720,-,9,4,13,known,chr10:11498469-11498720
sample_2_Aligned.sortedByCoord.out,chr1,40451492,40455139,-,8,3,11,novel,chr1:40451492-40455139
sample_2_Aligned.sortedByCoord.out,chr22,2965492,2973597,+,10,3,13,novel,chr22:2965492-2973597
sample_2_Aligned.sortedByCoord.out,chr22,40201052,40205995,-,8,2,10,known,chr22:40201052-40205995
sample_2_Aligned.sortedByCoord.out,chr9,14536766,14544555,+,12,2,14,known,chr9:14536766-14544555
sample_2_Aligned.sortedByCoord.out,chr20,8377979,8378180,-,4,1,5,known,chr20:8377979-8378180
sample_2_Aligned.sortedByCoord.out,chr17,6685211,6687132,+,9,1,10,known,chr17:6685211-6687132
sample_2_Aligned.sortedByCoord.out,chr6,1630809,1639693,+,9,3,12,known,chr6:1630809-1639693
sample_2_Aligned.sortedByCoord.out,chr15,32387950,32392722,-,17,6,23,known,chr15:32387950-32392722
sample_2_Aligned.sortedByCoord.out,chr18,29969843,29976893,+,13,3,16,known,chr18:29969843-29976893
sample_2_Aligned.sortedByCoord.out,chr9,48750571,48752766,-,15,0,15,known,chr9:48750571-48752766
sample_2_Aligned.sortedByCoord.out,chr16,7241157,7244914,-,14,4,18,novel,chr16:7241157-7244914
sample_2_Aligned.sortedByCoord.out,chr8,11670987,11677852,-,5,2,7,novel,chr8:11670987-11677852
sample_2_Aligned.sortedByCoord.out,chr3,20284620,20286767,+,7,5,12,known,chr3:20284620-20286767
sample_2_Aligned.sortedByCoord.out,chr12,8245748,8254274,-,9,6,15,novel,chr12:8245748-8254274
sample_2_Aligned.sortedByCoord.out,chr8,15956256,15965473,+,15,1,16,known,chr8:15956256-15965473
sample_2_Aligned.sortedByCoord.out,chr2,23275728,23278928,-,8,2,10,known,chr2:23275728-23278928
sample_2_Aligned.sortedByCoord.out,chr8,33499289,33504247,-,6,2,8,known,chr8:33499289-33504247
sample_2_Aligned.sortedByCoord.out,chr3,39506507,39509207,-,10,0,10,novel,chr3:39506507-39509207
sample_2_Aligned.sortedByCoord.out,chr11,45497244,45498990,-,12,1,13,known,chr11:45497244-45498990
sample_2_Aligned.sortedByCoord.out,chr19,33170356,33180181,+,7,2,9,known,chr19:33170356-33180181
sample_2_Aligned.sortedByCoord.out,chr12,36386534,36394521,-,15,1,16,known,chr12:36386534-36394521
sample_2_Aligned.sortedByCoord.out,chr6,14822576,14822943,+,9,2,11,known,chr6:14822576-14822943
sample_2_Aligned.sortedByCoord.out,chr21,45495933,45505133,-,11,5,16,known,chr21:45495933-45505133
sample_2_Aligned.sortedByCoord.out,chr3,7364149,7373424,+,14,1,15,known,chr3:7364149-7373424
sample_2_Aligned.sortedByCoord.out,chr12,11385359,11388056,-,13,0,13,known,chr12:11385359-11388056
sample_2_Aligned.sortedByCoord.out,chr7,38979493,38988628,+,6,0,6,known,chr7:38979493-38988628
sample_2_Aligned.sortedByCoord.out,chr11,19580488,19580856,+,16,3,19,novel,chr11:19580488-19580856
sample_2_Aligned.sortedByCoord.out,chr20,29123328,29125635,+,5,2,7,novel,chr20:29123328-29125635
sample_2_Aligned.sortedByCoord.out,chr12,16237028,16238073,-,3,1,4,known,chr12:16237028-16238073
sample_2_Aligned.sortedByCoord.out,chr13,43913421,43916420,+,10,3,13,known,chr13:43913421-43916420
sample_2_Aligned.sortedByCoord.out,chr1,49415233,49415683,+,6,0,6,novel,chr1:49415233-49415683
sample_2_Aligned.sortedByCoord.out,chr5,6056059,6066058,-,17,1,18,known,chr5:6056059-6066058
sample_2_Aligned.sortedByCoord.out,chr5,6193077,6199838,-,12,1,13,known,chr5:6193077-6199838
sample_2_Aligned.sortedByCoord.out,chr4,22393836,22400585,-,14,3,17,known,chr4:22393836-22400585
sample_2_Aligned.sortedByCoord.out,chr19,5288929,5298435,-,5,1,6,known,chr19:5288929-5298435
sample_2_Aligned.sortedByCoord.out,chr15,45309320,45315880,+,16,1,17,novel,chr15:45309320-45315880
sample_2_Aligned.sortedByCoord.out,chr9,27841299,27849135,+,7,2,9,known,chr9:27841299-27849135
sample_2_Aligned.sortedByCoord.out,chr1,10115275,10122024,+,9,0,9,known,chr1:10115275-10122024
sample_2_Aligned.sortedByCoord.out,chr13,14841611,14846993,+,6,2,8,known,chr13:14841611-14846993
sample_2_Aligned.sortedByCoord.out,chr11,13932311,13937482,-,8,4,12,known,chr11:13932311-13937482
sample_2_Aligned.sortedByCoord.out,chr20,16538524,16544933,+,9,3,12,known,chr20:16538524-16544933
sample_2_Aligned.sortedByCoord.out,chr12,9564180,9570603,-,13,2,15,known,chr12:9564180-9570603
sample_2_Aligned.sortedByCoord.out,chr13,19287745,19293890,-,8,1,9,known,chr13:19287745-19293890
sample_2_Aligned.sortedByCoord.out,chr7,8850746,8852877,+,10,2,12,novel,chr7:8850746-8852877
sample_2_Aligned.sortedByCoord.out,chr11,3531608,3536330,-,15,1,16,known,chr11:3531608-3536330
sample_2_Aligned.sortedByCoord.out,chr8,33880408,33887987,+,9,3,12,known,chr8:33880408-33887987
sample_2_Aligned.sortedByCoord.out,chr1,11239168,11248600,+,7,4,11,novel,chr1:11239168-11248600
sample_2_Aligned.sortedByCoord.out,chr14,49445905,49453706,-,6,2,8,known,chr14:49445905-49453706
sample_2_Aligned.sortedByCoord.out,chr12,31526576,31528741,-,12,0,12,novel,chr12:31526576-31528741
sample_2_Aligned.sortedByCoord.out,chr11,13883921,13890345,+,12,3,15,known,chr11:13883921-13890345
sample_2_Aligned.sortedByCoord.out,chr8,3568466,3569999,+,11,2,13,known,chr8:3568466-3569999
sample_2_Aligned.sortedByCoord.out,chr3,12552412,12556055,+,11,3,14,known,chr3:12552412-12556055
sample_2_Aligned.sortedByCoord.out,chr6,13111516,13118430,+,7,2,9,known,chr6:13111516-13118430
sample_2_Aligned.sortedByCoord.out,chr20,4342988,4352363,-,10,5,15,novel,chr20:4342988-4352363
sample_2_Aligned.sortedByCoord.out,chr19,45845378,45850442,+,10,1,11,known,chr19:45845378-45850442
sample_2_Aligned.sortedByCoord.out,chr4,20487519,20497415,+,5,1,6,known,chr4:20487519-20497415
sample_2_Aligned.sortedByCoord.out,chr18,4222695,4224104,-,18,1,19,known,chr18:4222695-4224104
sample_2_Aligned.sortedByCoord.out,chr19,20059596,20067910,+,10,3,13,known,chr19:20059596-20067910
sample_2_Aligned.sortedByCoord.out,chr11,17417541,17426706,+,13,2,15,novel,chr11:17417541-17426706
sample_2_Aligned.sortedByCoord.out,chr16,4533764,4533937,-,12,1,13,known,chr16:4533764-4533937
sample_2_Aligned.sortedByCoord.out,chr3,16239921,16240086,+,8,2,10,known,chr3:16239921-16240086
sample_2_Aligned.sortedByCoord.out,chr7,26538671,26540195,+,12,1,13,known,chr7:26538671-26540195
sample_2_Aligned.sortedByCoord.out,chr19,30277276,30285053,-,9,1,10,novel,chr19:30277276-30285053
sample_2_Aligned.sortedByCoord.out,chr17,13410916,13414701,+,4,4,8,novel,chr17:13410916-13414701
sample_2_Aligned.sortedByCoord.out,chr8,33182781,33185557,-,10,2,12,novel,chr8:33182781-33185557
sample_2_Aligned.sortedByCoord.out,chr19,25258284,25265394,+,8,3,11,novel,chr19:25258284-25265394
sample_2_Aligned.sortedByCoord.out,chr9,47513164,47521640,-,14,1,15,known,chr9:47513164-47521640
sample_2_Aligned.sortedByCoord.out,chr15,33917276,33921574,+,14,2,16,known,chr15:33917276-33921574
sample_2_Aligned.sortedByCoord.out,chr3,44813609,44820764,+,8,3,11,known,chr3:44813609-44820764
sample_2_Aligned.sortedByCoord.out,chr4,31798340,31807847,-,13,2,15,known,chr4:31798340-31807847
sample_2_Aligned.sortedByCoord.out,chr18,38341386,38344829,-,4,1,5,known,chr18:38341386-38344829
sample_2_Aligned.sortedByCoord.out,chr8,46300771,46304049,+,12,1,13,known,chr8:46300771-46304049
sample_2_Aligned.sortedByCoord.out,chr9,42189484,42193077,-,13,2,15,known,chr9:42189484-42193077
sample_2_Aligned.sortedByCoord.out,chr8,40695125,40703391,+,15,2,17,known,chr8:40695125-40703391
sample_2_Aligned.sortedByCoord.out,chr18,2086999,2091817,+,14,3,17,novel,chr18:2086999-2091817
sample_2_Aligned.sortedByCoord.out,chr9,31803140,31805887,+,9,4,13,known,chr9:31803140-31805887
sample_2_Aligned.sortedByCoord.out,chr21,28010201,28010693,-,12,4,16,novel,chr21:28010201-28010693
sample_2_Aligned.sortedByCoord.out,chr17,37665838,37673652,-,11,1,12,known,chr17:37665838-37673652
sample_2_Aligned.sortedByCoord.out,chr20,35361192,35363111,+,4,3,7,known,chr20:35361192-35363111
sample_2_Aligned.sortedByCoord.out,chr14,25254324,25257041,+,10,2,12,known,chr14:25254324-25257041
sample_2_Aligned.sortedByCoord.out,chr22,38675253,38682685,+,7,2,9,known,chr22:38675253-38682685
sample_2_Aligned.sortedByCoord.out,chr6,24513301,24515909,+,10,2,12,known,chr6:24513301-24515909
sample_2_Aligned.sortedByCoord.out,chr21,4396843,4403402,-,19,2,21,known,chr21:4396843-4403402
sample_2_Aligned.sortedByCoord.out,chr7,39974176,39979008,+,16,1,17,known,chr7:39974176-39979008
sample_2_Aligned.sortedByCoord.out,chr8,24456366,24464343,-,10,2,12,known,chr8:24456366-24464343
sample_2_Aligned.sortedByCoord.out,chr6,24525758,24528561,-,17,4,21,known,chr6:24525758-24528561
sample_2_Aligned.sortedByCoord.out,chr1,14540305,14545035,-,11,4,15,known,chr1:14540305-14545035
sample_2_Aligned.sortedByCoord.out,chr9,17810889,17814248,-,10,3,13,known,chr9:17810889-17814248
sample_2_Aligned.sortedByCoord.out,chr5,13271683,13273547,-,6,2,8,known,chr5:13271683-13273547
sample_2_Aligned.sortedByCoord.out,chr17,48176658,48178012,+,11,2,13,known,chr17:48176658-48178012
sample_2_Aligned.sortedByCoord.out,chr10,36589680,36593553,-,11,3,14,known,chr10:36589680-36593553
sample_2_Aligned.sortedByCoord.out,chr22,35532565,35542335,+,7,5,12,known,chr22:35532565-35542335
sample_2_Aligned.sortedByCoord.out,chr21,12622543,12623063,+,13,3,16,novel,chr21:12622543-12623063
sample_2_Aligned.sortedByCoord.out,chr18,25070516,25079694,-,11,1,12,novel,chr18:25070516-25079694
sample_2_Aligned.sortedByCoord.out,chr11,12858016,12858419,-,12,3,15,known,chr11:12858016-12858419
sample_2_Aligned.sortedByCoord.out,chr12,9338777,9341442,+,15,3,18,known,chr12:9338777-9341442
sample_2_Aligned.sortedByCoord.out,chr12,31953015,31957901,+,6,1,7,known,chr12:31953015-31957901
sample_2_Aligned.sortedByCoord.out,chr3,42568641,42570381,+,10,0,10,known,chr3:42568641-42570381
sample_2_Aligned.sortedByCoord.out,chr12,43519710,43522091,+,11,1,12,known,chr12:43519710-43522091
sample_2_Aligned.sortedByCoord.out,chr20,35993820,35996405,-,10,2,12,novel,chr20:35993820-35996405
sample_2_Aligned.sortedByCoord.out,chr1,33513997,33516769,+,13,1,14,known,chr1:33513997-33516769
sample_2_Aligned.sortedByCoord.out,chr3,14688124,14692256,-,7,2,9,novel,chr3:14688124-14692256
sample_2_Aligned.sortedByCoord.out,chr13,3307285,3314363,-,8,2,10,novel,chr13:3307285-3314363
sample_2_Aligned.sortedByCoord.out,chr8,17357834,17359229,+,8,4,12,known,chr8:17357834-17359229
sample_2_Aligned.sortedByCoord.out,chr15,37015714,37024571,+,10,0,10,known,chr15:37015714-37024571
sample_2_Aligned.sortedByCoord.out,chr15,44337180,44343738,+,13,2,15,known,chr15:44337180-44343738
sample_2_Aligned.sortedByCoord.out,chr5,7338339,7341471,-,12,3,15,known,chr5:7338339-7341471
sample_2_Aligned.sortedByCoord.out,chr22,15087591,15093642,+,11,2,13,known,chr22:15087591-15093642
sample_2_Aligned.sortedByCoord.out,chr14,4581925,4584242,-,12,3,15,novel,chr14:4581925-4584242
sample_2_Aligned.sortedByCoord.out,chr7,7186141,7188868,-,10,2,12,known,chr7:7186141-7188868
sample_2_Aligned.sortedByCoord.out,chr16,45927268,45931624,-,13,4,17,novel,chr16:45927268-45931624
sample_2_Aligned.sortedByCoord.out,chr7,44731315,44740212,-,7,2,9,known,chr7:44731315-44740212
sample_2_Aligned.sortedByCoord.out,chr12,31720193,31725480,+,10,3,13,novel,chr12:31720193-31725480
sample_2_Aligned.sortedByCoord.out,chr22,26699317,26702198,+,12,1,13,novel,chr22:26699317-26702198
sample_2_Aligned.sortedByCoord.out,chr12,21033760,21038337,-,8,2,10,known,chr12:21033760-21038337
sample_2_Aligned.sortedByCoord.out,chr18,35494475,35498175,+,6,0,6,known,chr18:35494475-35498175
sample_2_Aligned.sortedByCoord.out,chr9,48110773,48118437,-,5,4,9,known,chr9:48110773-48118437
sample_2_Aligned.sortedByCoord.out,chr6,42980964,42986294,+,9,1,10,known,chr6:42980964-42986294
sample_2_Aligned.sortedByCoord.out,chr19,7706985,7716158,-,11,1,12,known,chr19:7706985-7716158
sample_2_Aligned.sortedByCoord.out,chr20,28168163,28172238,+,13,0,13,known,chr20:28168163-28172238
sample_2_Aligned.sortedByCoord.out,chr10,34740908,34749789,+,10,1,11,novel,chr10:34740908-34749789
sample_2_Aligned.sortedByCoord.out,chr13,12783847,12790764,-,10,2,12,known,chr13:12783847-12790764
sample_2_Aligned.sortedByCoord.out,chr22,13248278,13252218,+,13,1,14,known,chr22:13248278-13252218
sample_2_Aligned.sortedByCoord.out,chr22,36094812,36104178,+,15,2,17,novel,chr22:36094812-36104178
sample_2_Aligned.sortedByCoord.out,chr16,43932791,43939458,+,7,1,8,novel,chr16:43932791-43939458
sample_2_Aligned.sortedByCoord.out,chr2,47469852,47478180,-,7,1,8,known,chr2:47469852-47478180
sample_2_Aligned.sortedByCoord.out,chr22,49785055,49790492,+,11,6,17,known,chr22:49785055-49790492
sample_2_Aligned.sortedByCoord.out,chr9,11623256,11624306,+,6,4,10,known,chr9:11623256-11624306
sample_2_Aligned.sortedByCoord.out,chr17,21364730,21372660,+,12,2,14,novel,chr17:21364730-21372660
sample_2_Aligned.sortedByCoord.out,chr2,25273783,25279775,-,8,2,10,known,chr2:25273783-25279775
sample_2_Aligned.sortedByCoord.out,chr10,47016362,47018544,+,10,1,11,known,chr10:47016362-47018544
sample_2_Aligned.sortedByCoord.out,chr18,22890714,22895657,-,8,1,9,novel,chr18:22890714-22895657
sample_2_Aligned.sortedByCoord.out,chr11,14057027,14061273,-,11,3,14,known,chr11:14057027-14061273
sample_2_Aligned.sortedByCoord.out,chr20,20005308,20014671,-,11,0,11,known,chr20:20005308-20014671
sample_2_Aligned.sortedByCoord.out,chr8,15061720,15064366,+,14,1,15,known,chr8:15061720-15064366
sample_2_Aligned.sortedByCoord.out,chr18,5955171,5963260,+,9,1,10,known,chr18:5955171-5963260
sample_2_Aligned.sortedByCoord.out,chr1,33661048,33669650,-,4,2,6,known,chr1:33661048-33669650
sample_2_Aligned.sortedByCoord.out,chr1,26968935,26975537,-,8,0,8,known,chr1:26968935-26975537
sample_2_Aligned.sortedByCoord.out,chr18,23525270,23532117,-,9,3,12,known,chr18:23525270-23532117
sample_2_Aligned.sortedByCoord.out,chr5,17540228,17549173,+,9,4,13,known,chr5:17540228-17549173
sample_2_Aligned.sortedByCoord.out,chr19,44931787,44936113,-,11,1,12,known,chr19:44931787-44936113
sample_2_Aligned.sortedByCoord.out,chr7,13910822,13915994,-,10,2,12,known,chr7:13910822-13915994
sample_2_Aligned.sortedByCoord.out,chr21,34496792,34499592,-,11,2,13,known,chr21:34496792-34499592
sample_2_Aligned.sortedByCoord.out,chr5,3276147,3278124,-,8,3,11,known,chr5:3276147-3278124
sample_2_Aligned.sortedByCoord.out,chr2,40490107,40491895,+,7,3,10,novel,chr2:40490107-40491895
sample_2_Aligned.sortedByCoord.out,chr17,46435563,46440546,+,7,3,10,known,chr17:46435563-46440546
sample_2_Aligned.sortedByCoord.out,chr2,29980547,29981989,-,7,4,11,known,chr2:29980547-29981989
sample_2_Aligned.sortedByCoord.out,chr1,39100711,39105815,+,19,3,22,known,chr1:39100711-39105815
sample_2_Aligned.sortedByCoord.out,chr20,42338662,42346615,-,6,4,10,known,chr20:42338662-42346615
sample_2_Aligned.sortedByCoord.out,chr22,3673471,3681768,+,9,4,13,known,chr22:3673471-3681768
sample_2_Aligned.sortedByCoord.out,chr5,40304442,40314105,+,12,5,17,novel,chr5:40304442-40314105
sample_2_Aligned.sortedByCoord.out,chr11,41200807,41202445,+,9,2,11,known,chr11:41200807-41202445
sample_2_Aligned.sortedByCoord.out,chr12,17291215,17291378,-,5,2,7,known,chr12:17291215-17291378
sample_2_Aligned.sortedByCoord.out,chr1,1529174,1538057,-,11,0,11,novel,chr1:1529174-1538057
sample_2_Aligned.sortedByCoord.out,chr10,5501566,5504263,+,7,4,11,known,chr10:5501566-5504263
sample_2_Aligned.sortedByCoord.out,chr18,38644301,38646839,-,12,2,14,known,chr18:38644301-38646839
sample_2_Aligned.sortedByCoord.out,chr2,20601873,20608222,-,10,3,13,known,chr2:20601873-20608222
sample_2_Aligned.sortedByCoord.out,chr5,47306058,47309930,-,12,3,15,known,chr5:47306058-47309930
sample_2_Aligned.sortedByCoord.out,chr7,35486925,35488761,-,11,2,13,known,chr7:35486925-35488761
sample_2_Aligned.sortedByCoord.out,chr14,10953636,10953843,-,10,1,11,novel,chr14:10953636-10953843
sample_2_Aligned.sortedByCoord.out,chr7,10772596,10773657,+,10,3,13,known,chr7:10772596-10773657
sample_2_Aligned.sortedByCoord.out,chr15,41735888,41736906,+,9,2,11,known,chr15:41735888-41736906
sample_2_Aligned.sortedByCoord.out,chr20,16958574,16963255,-,10,2,12,novel,chr20:16958574-16963255
sample_2_Aligned.sortedByCoord.out,chr20,10223429,10223628,-,10,1,11,known,chr20:10223429-10223628
sample_2_Aligned.sortedByCoord.out,chr10,31907102,31912156,+,16,1,17,known,chr10:31907102-31912156
sample_2_Aligned.sortedByCoord.out,chr19,35746526,35750596,+,9,2,11,novel,chr19:35746526-35750596
sample_2_Aligned.sortedByCoord.out,chr20,27306804,27315225,+,6,3,9,novel,chr20:27306804-27315225
sample_2_Aligned.sortedByCoord.out,chr3,16496792,16499930,-,8,1,9,known,chr3:16496792-16499930
sample_2_Aligned.sortedByCoord.out,chr17,41087611,41088492,-,5,4,9,known,chr17:41087611-41088492
sample_2_Aligned.sortedByCoord.out,chr5,26396553,26397941,-,15,4,19,known,chr5:26396553-26397941
sample_2_Aligned.sortedByCoord.out,chr12,27463202,27471867,-,10,2,12,known,chr12:27463202-27471867
sample_2_Aligned.sortedByCoord.out,chr6,13258952,13268156,-,11,2,13,known,chr6:13258952-13268156
sample_2_Aligned.sortedByCoord.out,chr3,23241998,23244525,+,7,5,12,novel,chr3:23241998-23244525
sample_2_Aligned.sortedByCoord.out,chr16,3862908,3869297,+,10,4,14,novel,chr16:3862908-3869297
sample_2_Aligned.sortedByCoord.out,chr17,41581436,41585170,-,9,1,10,known,chr17:41581436-41585170
sample_2_Aligned.sortedByCoord.out,chr11,48548858,48551207,+,9,3,12,known,chr11:48548858-48551207
sample_2_Aligned.sortedByCoord.out,chr14,8310423,8318803,+,13,0,13,known,chr14:8310423-8318803
sample_2_Aligned.sortedByCoord.out,chr7,41745633,41753561,-,15,1,16,known,chr7:41745633-41753561
sample_2_Aligned.sortedByCoord.out,chr14,21004903,21007202,-,10,2,12,known,chr14:21004903-21007202
sample_2_Aligned.sortedByCoord.out,chr22,9119379,9120316,+,6,2,8,known,chr22:9119379-9120316
sample_2_Aligned.sortedByCoord.out,chr22,33826849,33834713,+,12,0,12,known,chr22:33826849-33834713
sample_2_Aligned.sortedByCoord.out,chr16,2286936,2287382,+,10,1,11,known,chr16:2286936-2287382
sample_2_Aligned.sortedByCoord.out,chr20,32244953,32247652,+,9,2,11,known,chr20:32244953-32247652
sample_2_Aligned.sortedByCoord.out,chr3,40752237,40757056,+,7,2,9,novel,chr3:40752237-40757056
sample_2_Aligned.sortedByCoord.out,chr11,31340299,31343382,+,12,1,13,known,chr11:31340299-31343382
sample_2_Aligned.sortedByCoord.out,chr17,25979570,25982550,+,6,0,6,known,chr17:25979570-25982550
sample_2_Aligned.sortedByCoord.out,chr9,5378141,5382592,+,12,3,15,known,chr9:5378141-5382592
sample_2_Aligned.sortedByCoord.out,chr18,17163599,17171050,-,9,6,15,known,chr18:17163599-17171050
sample_2_Aligned.sortedByCoord.out,chr14,30094976,30100227,-,7,2,9,novel,chr14:30094976-30100227
sample_2_Aligned.sortedByCoord.out,chr8,43849034,43858277,+,16,3,19,novel,chr8:43849034-43858277
sample_2_Aligned.sortedByCoord.out,chr14,28051964,28054299,-,6,4,10,known,chr14:28051964-28054299
sample_2_Aligned.sortedByCoord.out,chr7,32759965,32769160,+,17,0,17,known,chr7:32759965-32769160
sample_2_Aligned.sortedByCoord.out,chr12,36903444,36909102,-,5,3,8,known,chr12:36903444-36909102
sample_2_Aligned.sortedByCoord.out,chr6,30013199,30014739,-,10,2,12,known,chr6:30013199-30014739
sample_2_Aligned.sortedByCoord.out,chr5,8880916,8884124,+,10,1,11,known,chr5:8880916-8884124
sample_2_Aligned.sortedByCoord.out,chr10,14026481,14035743,-,8,1,9,known,chr10:14026481-14035743
sample_2_Aligned.sortedByCoord.out,chr8,15017608,15017874,+,7,0,7,novel,chr8:15017608-15017874
sample_2_Aligned.sortedByCoord.out,chr19,29235912,29238363,-,11,2,13,novel,chr19:29235912-29238363
sample_2_Aligned.sortedByCoord.out,chr19,12406804,12414888,-,9,0,9,known,chr19:12406804-12414888
sample_2_Aligned.sortedByCoord.out,chr5,12840915,12841706,+,4,0,4,known,chr5:12840915-12841706
sample_2_Aligned.sortedByCoord.out,chr9,29762071,29766999,+,7,6,13,known,chr9:29762071-29766999
sample_2_Aligned.sortedByCoord.out,chr15,18764551,18768714,+,7,2,9,known,chr15:18764551-18768714
sample_2_Aligned.sortedByCoord.out,chr9,10960800,10970204,-,10,2,12,known,chr9:10960800-10970204
sample_2_Aligned.sortedByCoord.out,chr8,23615146,23621079,+,10,2,12,known,chr8:23615146-23621079
sample_2_Aligned.sortedByCoord.out,chr12,11304438,11307566,-,17,0,17,known,chr12:11304438-11307566
sample_2_Aligned.sortedByCoord.out,chr3,15016852,15019179,+,8,5,13,novel,chr3:15016852-15019179
sample_2_Aligned.sortedByCoord.out,chr18,23122331,23126269,+,12,2,14,known,chr18:23122331-23126269
sample_2_Aligned.sortedByCoord.out,chr10,18495501,18495970,-,13,3,16,known,chr10:18495501-18495970
sample_2_Aligned.sortedByCoord.out,chr11,1090428,1093308,+,6,2,8,known,chr11:1090428-1093308
sample_2_Aligned.sortedByCoord.out,chr2,26926553,26930047,+,11,0,11,known,chr2:26926553-26930047
sample_2_Aligned.sortedByCoord.out,chr11,30847746,30850576,+,12,1,13,known,chr11:30847746-30850576
sample_2_Aligned.sortedByCoord.out,chr3,3812850,3820642,+,12,2,14,known,chr3:3812850-3820642
sample_2_Aligned.sortedByCoord.out,chr1,45803143,45808374,-,8,0,8,known,chr1:45803143-45808374
sample_2_Aligned.sortedByCoord.out,chr5,5387100,5396119,-,13,3,16,known,chr5:5387100-5396119
sample_2_Aligned.sortedByCoord.out,chr3,34000632,34002131,+,15,5,20,novel,chr3:34000632-34002131
sample_2_Aligned.sortedByCoord.out,chr12,48656566,48666038,+,10,0,10,known,chr12:48656566-48666038
sample_2_Aligned.sortedByCoord.out,chr15,23638664,23643982,+,7,2,9,known,chr15:23638664-23643982
sample_2_Aligned.sortedByCoord.out,chr20,47804426,47813728,+,10,1,11,novel,chr20:47804426-47813728
sample_2_Aligned.sortedByCoord.out,chr13,21050486,21050978,+,12,2,14,novel,chr13:21050486-21050978
sample_2_Aligned.sortedByCoord.out,chr15,22291091,22300389,+,6,1,7,known,chr15:22291091-22300389
sample_2_Aligned.sortedByCoord.out,chr5,33459553,33467077,+,15,1,16,novel,chr5:33459553-33467077
sample_2_Aligned.sortedByCoord.out,chr4,39793470,39796094,-,13,0,13,novel,chr4:39793470-39796094
sample_2_Aligned.sortedByCoord.out,chr12,21783078,21787504,+,14,0,14,known,chr12:21783078-21787504
sample_2_Aligned.sortedByCoord.out,chr18,46946511,46951322,-,10,5,15,known,chr18:46946511-46951322
sample_2_Aligned.sortedByCoord.out,chr8,33369155,33373869,-,10,5,15,known,chr8:33369155-33373869
sample_2_Aligned.sortedByCoord.out,chr15,2151931,2155887,+,7,2,9,known,chr15:2151931-2155887
sample_2_Aligned.sortedByCoord.out,chr9,12602939,12609966,-,10,1,11,novel,chr9:12602939-12609966
sample_2_Aligned.sortedByCoord.out,chr2,20888064,20894638,+,12,5,17,known,chr2:20888064-20894638
sample_2_Aligned.sortedByCoord.out,chr9,11864060,11866288,+,8,2,10,known,chr9:11864060-11866288
sample_2_Aligned.sortedByCoord.out,chr18,30728713,30731250,+,12,1,13,known,chr18:30728713-30731250
sample_2_Aligned.sortedByCoord.out,chr19,40789989,40796077,+,5,4,9,known,chr19:40789989-40796077
sample_2_Aligned.sortedByCoord.out,chr15,26646335,26654112,-,6,1,7,known,chr15:26646335-26654112
sample_2_Aligned.sortedByCoord.out,chr14,35165538,35168810,-,13,4,17,known,chr14:35165538-35168810
sample_2_Aligned.sortedByCoord.out,chr19,16313936,16319415,-,15,3,18,novel,chr19:16313936-16319415
sample_2_Aligned.sortedByCoord.out,chr19,21024403,21025855,+,8,2,10,novel,chr19:21024403-21025855
sample_2_Aligned.sortedByCoord.out,chr3,47098560,47108124,+,11,1,12,novel,chr3:47098560-47108124
sample_2_Aligned.sortedByCoord.out,chr17,35401168,35403471,-,10,2,12,known,chr17:35401168-35403471
sample_2_Aligned.sortedByCoord.out,chr9,23681946,23685916,+,9,3,12,known,chr9:23681946-23685916
sample_2_Aligned.sortedByCoord.out,chr20,5347013,5351408,-,11,4,15,known,chr20:5347013-5351408
sample_2_Aligned.sortedByCoord.out,chr16,12110100,12119625,+,5,0,5,known,chr16:12110100-12119625
sample_2_Aligned.sortedByCoord.out,chr15,17554483,17561211,+,12,1,13,known,chr15:17554483-17561211
sample_2_Aligned.sortedByCoord.out,chr11,21262817,21264139,-,8,1,9,known,chr11:21262817-21264139
sample_2_Aligned.sortedByCoord.out,chr8,12542124,12544837,-,13,2,15,known,chr8:12542124-12544837
sample_2_Aligned.sortedByCoord.out,chr7,30828408,30836437,-,6,1,7,known,chr7:30828408-30836437
sample_2_Aligned.sortedByCoord.out,chr20,37666524,37667882,+,8,3,11,known,chr20:37666524-37667882
sample_2_Aligned.sortedByCoord.out,chr1,17251227,17252949,-,14,3,17,known,chr1:17251227-17252949
sample_2_Aligned.sortedByCoord.out,chr17,22788456,22789779,+,8,3,11,known,chr17:22788456-22789779
sample_2_Aligned.sortedByCoord.out,chr4,14357706,14363426,+,11,3,14,novel,chr4:14357706-14363426
sample_2_Aligned.sortedByCoord.out,chr3,17003780,17007632,-,10,3,13,novel,chr3:17003780-17007632
sample_2_Aligned.sortedByCoord.out,chr9,35971754,35979549,-,15,0,15,known,chr9:35971754-35979549
sample_2_Aligned.sortedByCoord.out,chr1,22879745,22885720,-,7,3,10,novel,chr1:22879745-22885720
sample_2_Aligned.sortedByCoord.out,chr16,8761645,8765090,-,4,3,7,known,chr16:8761645-8765090
sample_2_Aligned.sortedByCoord.out,chr19,48590624,48598973,+,8,1,9,novel,chr19:48590624-48598973
sample_2_Aligned.sortedByCoord.out,chr16,4942090,4949913,-,7,2,9,known,chr16:4942090-4949913
sample_2_Aligned.sortedByCoord.out,chr16,32557189,32558857,+,4,1,5,novel,chr16:32557189-32558857
sample_2_Aligned.sortedByCoord.out,chr16,29005101,29005724,+,11,1,12,known,chr16:29005101-29005724
sample_2_Aligned.sortedByCoord.out,chr7,20479950,20482372,+,6,3,9,known,chr7:20479950-20482372
sample_2_Aligned.sortedByCoord.out,chr4,13910017,13910987,-,14,2,16,known,chr4:13910017-13910987
sample_2_Aligned.sortedByCoord.out,chr10,5234272,5243775,+,10,1,11,novel,chr10:5234272-5243775
sample_2_Aligned.sortedByCoord.out,chr22,1574202,1581356,-,15,1,16,known,chr22:1574202-1581356
sample_2_Aligned.sortedByCoord.out,chr14,31595631,31598047,+,6,3,9,known,chr14:31595631-31598047
sample_2_Aligned.sortedByCoord.out,chr20,24756058,24765858,+,12,5,17,known,chr20:24756058-24765858
sample_2_Aligned.sortedByCoord.out,chr13,20787909,20793593,-,9,3,12,known,chr13:20787909-20793593
sample_2_Aligned.sortedByCoord.out,chr7,25161001,25165927,-,2,2,4,novel,chr7:25161001-25165927
sample_2_Aligned.sortedByCoord.out,chr3,10623243,10631439,+,10,0,10,novel,chr3:10623243-10631439
sample_2_Aligned.sortedByCoord.out,chr9,28827981,28833121,+,12,4,16,novel,chr9:28827981-28833121
sample_2_Aligned.sortedByCoord.out,chr1,35228422,35231921,-,10,1,11,known,chr1:35228422-35231921
sample_2_Aligned.sortedByCoord.out,chr3,33103513,33107112,-,12,2,14,known,chr3:33103513-33107112
sample_2_Aligned.sortedByCoord.out,chr1,35322119,35325919,-,6,4,10,known,chr1:35322119-35325919
sample_2_Aligned.sortedByCoord.out,chr21,10143993,10147429,-,7,2,9,known,chr21:10143993-10147429
sample_2_Aligned.sortedByCoord.out,chr17,48896582,48906195,+,5,3,8,known,chr17:48896582-48906195
sample_2_Aligned.sortedByCoord.out,chr10,23709829,23712974,+,10,2,12,known,chr10:23709829-23712974
sample_2_Aligned.sortedByCoord.out,chr15,11427187,11432004,-,8,2,10,novel,chr15:11427187-11432004
sample_2_Aligned.sortedByCoord.out,chr12,18116024,18123696,-,10,3,13,known,chr12:18116024-18123696
sample_2_Aligned.sortedByCoord.out,chr16,11960434,11962356,-,8,0,8,novel,chr16:11960434-11962356
sample_2_Aligned.sortedByCoord.out,chr10,41523362,41524460,-,6,1,7,known,chr10:41523362-41524460
sample_2_Aligned.sortedByCoord.out,chr9,11251603,11259754,-,10,2,12,known,chr9:11251603-11259754
sample_2_Aligned.sortedByCoord.out,chr14,19650115,19651986,-,11,1,12,known,chr14:19650115-19651986
sample_2_Aligned.sortedByCoord.out,chr19,13455719,13465489,-,7,1,8,known,chr19:13455719-13465489
sample_2_Aligned.sortedByCoord.out,chr15,5304887,5310283,+,16,0,16,known,chr15:5304887-5310283
sample_2_Aligned.sortedByCoord.out,chr6,8296611,8297702,+,10,1,11,known,chr6:8296611-8297702
sample_2_Aligned.sortedByCoord.out,chr9,43519514,43520332,+,5,1,6,known,chr9:43519514-43520332
sample_2_Aligned.sortedByCoord.out,chr6,27806493,27816298,+,16,1,17,known,chr6:27806493-27816298
sample_2_Aligned.sortedByCoord.out,chr19,47507327,47514659,-,10,2,12,novel,chr19:47507327-47514659
sample_2_Aligned.sortedByCoord.out,chr7,46191086,46194247,+,14,2,16,known,chr7:46191086-46194247
sample_2_Aligned.sortedByCoord.out,chr7,21165565,21169964,+,8,2,10,novel,chr7:21165565-21169964
sample_2_Aligned.sortedByCoord.out,chr16,12142023,12146776,+,12,2,14,novel,chr16:12142023-12146776
sample_2_Aligned.sortedByCoord.out,chr16,45494947,45496607,+,8,2,10,novel,chr16:45494947-45496607
sample_2_Aligned.sortedByCoord.out,chr16,33687147,33691066,+,11,2,13,novel,chr16:33687147-33691066
sample_2_Aligned.sortedByCoord.out,chr12,47476207,47484473,-,15,5,20,known,chr12:47476207-47484473
sample_2_Aligned.sortedByCoord.out,chr20,38429717,38430339,-,7,2,9,known,chr20:38429717-38430339
sample_2_Aligned.sortedByCoord.out,chr4,22482018,22483803,+,10,5,15,novel,chr4:22482018-22483803
sample_2_Aligned.sortedByCoord.out,chr4,47403651,47406103,+,12,4,16,novel,chr4:47403651-47406103
sample_2_Aligned.sortedByCoord.out,chr11,12175038,12180448,+,13,2,15,known,chr11:12175038-12180448
sample_2_Aligned.sortedByCoord.out,chr14,38621393,38622634,+,11,4,15,known,chr14:38621393-38622634
sample_2_Aligned.sortedByCoord.out,chr13,10612986,10616306,-,10,2,12,known,chr13:10612986-10616306
sample_2_Aligned.sortedByCoord.out,chr7,49593087,49600611,+,8,1,9,known,chr7:49593087-49600611
sample_2_Aligned.sortedByCoord.out,chr17,22566286,22573427,-,12,3,15,known,chr17:22566286-22573427
sample_2_Aligned.sortedByCoord.out,chr6,25137593,25143079,+,6,1,7,known,chr6:25137593-25143079
sample_2_Aligned.sortedByCoord.out,chr16,39910870,39911306,+,5,4,9,known,chr16:39910870-39911306
sample_2_Aligned.sortedByCoord.out,chr4,18025844,18027489,-,11,5,16,known,chr4:18025844-18027489
sample_2_Aligned.sortedByCoord.out,chr11,9166046,9171060,-,13,1,14,known,chr11:9166046-9171060
sample_2_Aligned.sortedByCoord.out,chr7,11066533,11068582,-,10,1,11,known,chr7:11066533-11068582
sample_2_Aligned.sortedByCoord.out,chr21,12857528,12860229,-,7,3,10,known,chr21:12857528-12860229
sample_2_Aligned.sortedByCoord.out,chr4,32594408,32600111,-,12,1,13,known,chr4:32594408-32600111
sample_2_Aligned.sortedByCoord.out,chr19,1457474,1459363,+,7,2,9,novel,chr19:1457474-1459363
sample_2_Aligned.sortedByCoord.out,chr1,30777990,30784370,+,15,6,21,known,chr1:30777990-30784370
sample_2_Aligned.sortedByCoord.out,chr10,44459592,44463489,-,9,2,11,novel,chr10:44459592-44463489
sample_2_Aligned.sortedByCoord.out,chr21,3855831,3865519,+,12,4,16,novel,chr21:3855831-3865519
sample_2_Aligned.sortedByCoord.out,chr9,6618417,6622390,+,5,1,6,known,chr9:6618417-6622390
sample_2_Aligned.sortedByCoord.out,chr12,40895019,40903781,+,13,1,14,novel,chr12:40895019-40903781
sample_2_Aligned.sortedByCoord.out,chr7,30604113,30610605,-,5,2,7,known,chr7:30604113-30610605
sample_2_Aligned.sortedByCoord.out,chr21,20104664,20112376,+,12,1,13,known,chr21:20104664-20112376
sample_2_Aligned.sortedByCoord.out,chr4,25221847,25228891,+,15,1,16,novel,chr4:25221847-25228891
sample_2_Aligned.sortedByCoord.out,chr8,10516440,10517483,+,11,4,15,novel,chr8:10516440-10517483
sample_2_Aligned.sortedByCoord.out,chr6,30645014,30647302,+,12,1,13,novel,chr6:30645014-30647302
sample_2_Aligned.sortedByCoord.out,chr7,6571746,6575443,+,18,4,22,known,chr7:6571746-6575443
sample_2_Aligned.sortedByCoord.out,chr22,4035662,4043590,+,10,2,12,known,chr22:4035662-4043590
sample_2_Aligned.sortedByCoord.out,chr8,5656035,5658365,+,10,1,11,novel,chr8:5656035-5658365
sample_2_Aligned.sortedByCoord.out,chr22,33104505,33108213,-,13,2,15,known,chr22:33104505-33108213
sample_2_Aligned.sortedByCoord.out,chr20,33309536,33318165,+,14,2,16,known,chr20:33309536-33318165
sample_2_Aligned.sortedByCoord.out,chr21,37212992,37222078,-,15,3,18,known,chr21:37212992-37222078
sample_2_Aligned.sortedByCoord.out,chr4,21956510,21963888,-,11,3,14,known,chr4:21956510-21963888
sample_2_Aligned.sortedByCoord.out,chr22,8949657,8953045,-,11,2,13,novel,chr22:8949657-8953045
sample_2_Aligned.sortedByCoord.out,chr18,32690437,32696997,-,13,5,18,known,chr18:32690437-32696997
sample_2_Aligned.sortedByCoord.out,chr12,46017046,46021812,-,13,2,15,novel,chr12:46017046-46021812
sample_2_Aligned.sortedByCoord.out,chr7,10068973,10078624,-,9,4,13,known,chr7:10068973-10078624
sample_2_Aligned.sortedByCoord.out,chr3,24522844,24524853,-,10,2,12,known,chr3:24522844-24524853
sample_2_Aligned.sortedByCoord.out,chr20,28521345,28526597,+,7,1,8,novel,chr20:28521345-28526597
sample_2_Aligned.sortedByCoord.out,chr22,13408741,13414813,-,7,3,10,known,chr22:13408741-13414813
sample_2_Aligned.sortedByCoord.out,chr20,2899813,2901241,-,11,1,12,known,chr20:2899813-2901241
sample_2_Aligned.sortedByCoord.out,chr14,9028461,9031257,-,12,2,14,known,chr14:9028461-9031257
sample_2_Aligned.sortedByCoord.out,chr17,2655314,2663174,+,6,0,6,known,chr17:2655314-2663174
sample_2_Aligned.sortedByCoord.out,chr2,27675286,27680101,+,6,0,6,novel,chr2:27675286-27680101
sample_2_Aligned.sortedByCoord.out,chr12,41623643,41626313,+,3,3,6,novel,chr12:41623643-41626313
sample_2_Aligned.sortedByCoord.out,chr11,28773967,28774330,+,8,2,10,known,chr11:28773967-28774330
sample_2_Aligned.sortedByCoord.out,chr5,30461538,30462299,+,5,1,6,known,chr5:30461538-30462299
sample_2_Aligned.sortedByCoord.out,chr13,6596653,6601080,-,12,0,12,known,chr13:6596653-6601080
sample_2_Aligned.sortedByCoord.out,chr9,13908335,13912379,-,7,1,8,known,chr9:13908335-13912379
sample_2_Aligned.sortedByCoord.out,chr14,5359606,5366397,-,11,1,12,novel,chr14:5359606-5366397
sample_2_Aligned.sortedByCoord.out,chr5,7599686,7606869,+,8,1,9,known,chr5:7599686-7606869
sample_2_Aligned.sortedByCoord.out,chr6,18898698,18898801,+,11,2,13,known,chr6:18898698-18898801
sample_2_Aligned.sortedByCoord.out,chr19,10909005,10916913,-,11,3,14,novel,chr19:10909005-10916913
sample_2_Aligned.sortedByCoord.out,chr8,21132763,21137936,-,15,0,15,known,chr8:21132763-21137936
sample_2_Aligned.sortedByCoord.out,chr20,47110278,47110870,+,9,2,11,known,chr20:47110278-47110870
sample_2_Aligned.sortedByCoord.out,chr18,38672733,38674958,+,12,2,14,novel,chr18:38672733-38674958
sample_2_Aligned.sortedByCoord.out,chr12,30575786,30581586,+,8,2,10,known,chr12:30575786-30581586
sample_2_Aligned.sortedByCoord.out,chr5,33198809,33199261,+,17,1,18,novel,chr5:33198809-33199261
sample_2_Aligned.sortedByCoord.out,chr19,5578784,5586629,+,7,0,7,known,chr19:5578784-5586629
sample_2_Aligned.sortedByCoord.out,chr8,4108580,4114141,+,11,2,13,known,chr8:4108580-4114141
sample_2_Aligned.sortedByCoord.out,chr19,10254251,10260529,+,11,2,13,known,chr19:10254251-10260529
sample_2_Aligned.sortedByCoord.out,chr21,31515985,31522116,+,13,0,13,known,chr21:31515985-31522116
sample_2_Aligned.sortedByCoord.out,chr10,38835811,38842101,+,8,1,9,novel,chr10:38835811-38842101
sample_2_Aligned.sortedByCoord.out,chr15,2736827,2744788,-,5,1,6,known,chr15:2736827-2744788
sample_2_Aligned.sortedByCoord.out,chr20,37590687,37595582,+,9,0,9,known,chr20:37590687-37595582
sample_2_Aligned.sortedByCoord.out,chr4,8414694,8415163,-,8,1,9,known,chr4:8414694-8415163
sample_2_Aligned.sortedByCoord.out,chr3,10123184,10127986,+,9,1,10,novel,chr3:10123184-10127986
sample_2_Aligned.sortedByCoord.out,chr3,5543458,5549896,+,8,2,10,known,chr3:5543458-5549896
sample_2_Aligned.sortedByCoord.out,chr9,27882455,27885235,+,9,3,12,known,chr9:27882455-27885235
sample_2_Aligned.sortedByCoord.out,chr20,47493173,47499282,+,6,3,9,known,chr20:47493173-47499282
sample_2_Aligned.sortedByCoord.out,chr10,48824237,48832420,-,14,5,19,novel,chr10:48824237-48832420
sample_2_Aligned.sortedByCoord.out,chr20,47344843,47350339,-,13,1,14,known,chr20:47344843-47350339
sample_2_Aligned.sortedByCoord.out,chr17,28998504,29006644,-,14,0,14,novel,chr17:28998504-29006644
sample_2_Aligned.sortedByCoord.out,chr6,4554497,4562025,+,11,1,12,novel,chr6:4554497-4562025
sample_2_Aligned.sortedByCoord.out,chr20,23958862,23964005,+,8,4,12,known,chr20:23958862-23964005
sample_2_Aligned.sortedByCoord.out,chr6,30856152,30865592,+,7,2,9,known,chr6:30856152-30865592
sample_2_Aligned.sortedByCoord.out,chr19,20750661,20755525,+,13,2,15,known,chr19:20750661-20755525
sample_2_Aligned.sortedByCoord.out,chr15,31771095,31774723,+,9,2,11,known,chr15:31771095-31774723
sample_2_Aligned.sortedByCoord.out,chr12,39255720,39256548,-,10,2,12,known,chr12:39255720-39256548
sample_2_Aligned.sortedByCoord.out,chr4,32910261,32915456,+,15,0,15,novel,chr4:32910261-32915456
sample_2_Aligned.sortedByCoord.out,chr21,2430032,2435961,-,6,3,9,known,chr21:2430032-2435961
sample_2_Aligned.sortedByCoord.out,chr14,39328250,39332703,-,6,2,8,known,chr14:39328250-39332703
sample_2_Aligned.sortedByCoord.out,chr1,14222451,14228199,+,8,3,11,novel,chr1:14222451-14228199
sample_2_Aligned.sortedByCoord.out,chr11,36954141,36962245,-,10,4,14,known,chr11:36954141-36962245
sample_2_Aligned.sortedByCoord.out,chr12,10123441,10132162,-,4,3,7,novel,chr12:10123441-10132162
sample_2_Aligned.sortedByCoord.out,chr1,12613833,12620790,-,7,1,8,known,chr1:12613833-12620790
sample_2_Aligned.sortedByCoord.out,chr5,46415381,46423325,-,7,1,8,known,chr5:46415381-46423325
sample_2_Aligned.sortedByCoord.out,chr22,9861988,9870818,-,8,2,10,novel,chr22:9861988-9870818
sample_2_Aligned.sortedByCoord.out,chr18,9095442,9095897,+,7,3,10,known,chr18:9095442-9095897
sample_2_Aligned.sortedByCoord.out,chr6,13927849,13936388,-,9,1,10,known,chr6:13927849-13936388
sample_2_Aligned.sortedByCoord.out,chr2,38840152,38848249,-,10,2,12,novel,chr2:38840152-38848249
sample_2_Aligned.sortedByCoord.out,chr1,46895643,46900165,-,15,0,15,known,chr1:46895643-46900165
sample_2_Aligned.sortedByCoord.out,chr4,19222736,19230598,+,9,2,11,novel,chr4:19222736-19230598
sample_2_Aligned.sortedByCoord.out,chr11,40018716,40027130,-,13,3,16,known,chr11:40018716-40027130
sample_2_Aligned.sortedByCoord.out,chr3,38868538,38873957,+,8,0,8,known,chr3:38868538-38873957
sample_2_Aligned.sortedByCoord.out,chr7,42124467,42126983,-,11,1,12,known,chr7:42124467-42126983
sample_2_Aligned.sortedByCoord.out,chr21,8215550,8220191,-,7,3,10,novel,chr21:8215550-8220191
sample_2_Aligned.sortedByCoord.out,chr4,35627535,35633434,+,7,0,7,known,chr4:35627535-35633434
sample_2_Aligned.sortedByCoord.out,chr21,23801700,23806666,-,13,1,14,known,chr21:23801700-23806666
sample_2_Aligned.sortedByCoord.out,chr11,7732920,7737017,+,10,2,12,known,chr11:7732920-7737017
sample_2_Aligned.sortedByCoord.out,chr22,26296937,26303263,+,6,1,7,known,chr22:26296937-26303263
sample_2_Aligned.sortedByCoord.out,chr9,46752402,46760283,+,7,3,10,known,chr9:46752402-46760283
sample_2_Aligned.sortedByCoord.out,chr11,3432162,3438652,-,13,1,14,novel,chr11:3432162-3438652
sample_2_Aligned.sortedByCoord.out,chr21,37411274,37415310,-,12,0,12,novel,chr21:37411274-37415310
sample_2_Aligned.sortedByCoord.out,chr4,4717546,4720077,-,9,2,11,known,chr4:4717546-4720077
sample_2_Aligned.sortedByCoord.out,chr1,43236837,43242525,-,11,3,14,novel,chr1:43236837-43242525
sample_2_Aligned.sortedByCoord.out,chr9,30409519,30414785,-,8,2,10,novel,chr9:30409519-30414785
sample_2_Aligned.sortedByCoord.out,chr11,25905759,25911815,-,14,2,16,known,chr11:25905759-25911815
sample_2_Aligned.sortedByCoord.out,chr8,41034808,41041555,+,8,1,9,novel,chr8:41034808-41041555
sample_2_Aligned.sortedByCoord.out,chr3,10919845,10926909,+,11,3,14,novel,chr3:10919845-10926909
sample_2_Aligned.sortedByCoord.out,chr7,18988503,18997968,+,9,3,12,known,chr7:18988503-18997968
sample_2_Aligned.sortedByCoord.out,chr5,34314713,34317318,+,14,3,17,known,chr5:34314713-34317318
sample_2_Aligned.sortedByCoord.out,chr8,16191841,16199467,-,13,3,16,known,chr8:16191841-16199467
sample_2_Aligned.sortedByCoord.out,chr5,27319463,27325338,-,9,4,13,known,chr5:27319463-27325338
sample_2_Aligned.sortedByCoord.out,chr13,46131435,46137783,-,14,1,15,known,chr13:46131435-46137783
sample_2_Aligned.sortedByCoord.out,chr16,3341177,3342854,-,14,3,17,known,chr16:3341177-3342854
sample_2_Aligned.sortedByCoord.out,chr19,8149367,8155430,+,9,6,15,novel,chr19:8149367-8155430
sample_2_Aligned.sortedByCoord.out,chr15,15598438,15607881,+,9,4,13,known,chr15:15598438-15607881
sample_2_Aligned.sortedByCoord.out,chr17,3284138,3287315,-,12,1,13,known,chr17:3284138-3287315
sample_2_Aligned.sortedByCoord.out,chr3,11587410,11596004,-,10,0,10,novel,chr3:11587410-11596004
sample_2_Aligned.sortedByCoord.out,chr8,40937121,40940762,+,11,3,14,novel,chr8:40937121-40940762
sample_2_Aligned.sortedByCoord.out,chr6,30317068,30318474,-,12,0,12,known,chr6:30317068-30318474
sample_2_Aligned.sortedByCoord.out,chr22,2671036,2673162,+,10,0,10,known,chr22:2671036-2673162
sample_2_Aligned.sortedByCoord.out,chr16,14389846,14396577,-,4,2,6,known,chr16:14389846-14396577
sample_2_Aligned.sortedByCoord.out,chr1,7841868,7842890,-,7,0,7,known,chr1:7841868-7842890
sample_2_Aligned.sortedByCoord.out,chr15,47354148,47363592,-,8,3,11,known,chr15:47354148-47363592
sample_2_Aligned.sortedByCoord.out,chr1,4836269,4837864,+,5,2,7,known,chr1:4836269-4837864
sample_2_Aligned.sortedByCoord.out,chr15,20250359,20257766,-,7,3,10,known,chr15:20250359-20257766
sample_2_Aligned.sortedByCoord.out,chr1,28392666,28400213,-,11,0,11,known,chr1:28392666-28400213
sample_2_Aligned.sortedByCoord.out,chr14,44483401,44489348,+,8,2,10,known,chr14:44483401-44489348
sample_2_Aligned.sortedByCoord.out,chr9,31161913,31167939,-,10,2,12,novel,chr9:31161913-31167939
sample_2_Aligned.sortedByCoord.out,chr9,36793258,36796728,+,15,3,18,known,chr9:36793258-36796728
sample_2_Aligned.sortedByCoord.out,chr4,48029818,48034617,-,10,2,12,known,chr4:48029818-48034617
sample_2_Aligned.sortedByCoord.out,chr7,28984209,28991328,-,10,4,14,known,chr7:28984209-28991328
sample_2_Aligned.sortedByCoord.out,chr19,1745290,1751589,-,10,1,11,known,chr19:1745290-1751589
sample_2_Aligned.sortedByCoord.out,chr17,49396485,49404692,-,8,1,9,known,chr17:49396485-49404692
sample_2_Aligned.sortedByCoord.out,chr20,35487972,35494465,-,13,3,16,known,chr20:35487972-35494465
sample_2_Aligned.sortedByCoord.out,chr12,47154610,47163746,+,11,0,11,known,chr12:47154610-47163746
sample_2_Aligned.sortedByCoord.out,chr20,5195074,5196466,-,8,4,12,known,chr20:5195074-5196466
sample_2_Aligned.sortedByCoord.out,chr19,12978892,12985814,+,16,3,19,known,chr19:12978892-12985814
sample_2_Aligned.sortedByCoord.out,chr13,16048795,16058293,-,11,1,12,known,chr13:16048795-16058293
sample_2_Aligned.sortedByCoord.out,chr4,46927960,46934183,+,7,2,9,known,chr4:46927960-46934183
sample_2_Aligned.sortedByCoord.out,chr16,33020385,33028183,-,10,0,10,known,chr16:33020385-33028183
sample_2_Aligned.sortedByCoord.out,chr18,44504252,44505672,+,8,2,10,known,chr18:44504252-44505672
sample_2_Aligned.sortedByCoord.out,chr1,43066654,43070867,-,9,0,9,known,chr1:43066654-43070867
sample_2_Aligned.sortedByCoord.out,chr13,12856974,12860425,+,11,2,13,known,chr13:12856974-12860425
sample_2_Aligned.sortedByCoord.out,chr1,49575898,49578295,-,8,3,11,novel,chr1:49575898-49578295
sample_2_Aligned.sortedByCoord.out,chr17,16196115,16196642,+,12,1,13,known,chr17:16196115-16196642
sample_2_Aligned.sortedByCoord.out,chr22,38818298,38824314,-,9,1,10,novel,chr22:38818298-38824314
sample_2_Aligned.sortedByCoord.out,chr14,27968377,27974699,-,14,2,16,known,chr14:27968377-27974699
sample_2_Aligned.sortedByCoord.out,chr4,11438560,11439104,+,10,1,11,known,chr4:11438560-11439104
sample_2_Aligned.sortedByCoord.out,chr4,8487332,8496863,+,8,0,8,novel,chr4:8487332-8496863
sample_2_Aligned.sortedByCoord.out,chr13,3937728,3944274,-,12,2,14,novel,chr13:3937728-3944274
sample_2_Aligned.sortedByCoord.out,chr7,10680355,10689244,+,12,0,12,known,chr7:10680355-10689244
sample_2_Aligned.sortedByCoord.out,chr18,19580760,19583661,-,7,1,8,known,chr18:19580760-19583661
sample_2_Aligned.sortedByCoord.out,chr22,26981164,26988853,+,10,2,12,known,chr22:26981164-26988853
sample_2_Aligned.sortedByCoord.out,chr22,13999127,14002077,+,5,1,6,novel,chr22:13999127-14002077
sample_2_Aligned.sortedByCoord.out,chr8,23134111,23137949,+,10,1,11,known,chr8:23134111-23137949
sample_2_Aligned.sortedByCoord.out,chr15,35670749,35672813,-,14,2,16,known,chr15:35670749-35672813
sample_2_Aligned.sortedByCoord.out,chr4,42381286,42389199,+,9,4,13,known,chr4:42381286-42389199
sample_2_Aligned.sortedByCoord.out,chr15,31768084,31777834,+,11,1,12,novel,chr15:31768084-31777834
sample_2_Aligned.sortedByCoord.out,chr6,3484654,3493714,+,15,1,16,known,chr6:3484654-3493714
sample_2_Aligned.sortedByCoord.out,chr22,13436105,13436880,+,6,2,8,novel,chr22:13436105-13436880
sample_2_Aligned.sortedByCoord.out,chr15,47262256,47272213,+,6,3,9,known,chr15:47262256-47272213
sample_2_Aligned.sortedByCoord.out,chr3,32319727,32322895,-,9,3,12,known,chr3:32319727-32322895
sample_2_Aligned.sortedByCoord.out,chr17,3310003,3319900,-,16,0,16,known,chr17:3310003-3319900
sample_2_Aligned.sortedByCoord.out,chr16,4673703,4683290,+,9,2,11,known,chr16:4673703-4683290
sample_3_Aligned.sortedByCoord.out,chr4,21242195,21246906,-,7,3,10,novel,chr4:21242195-21246906
sample_3_Aligned.sortedByCoord.out,chr10,24200193,24209148,-,16,2,18,known,chr10:24200193-24209148
sample_3_Aligned.sortedByCoord.out,chr1,21898448,21907013,+,6,1,7,known,chr1:21898448-21907013
sample_3_Aligned.sortedByCoord.out,chr9,18634371,18638132,-,15,6,21,novel,chr9:18634371-18638132
sample_3_Aligned.sortedByCoord.out,chr20,44194453,44200500,+,7,1,8,novel,chr20:44194453-44200500
sample_3_Aligned.sortedByCoord.out,chr11,42110894,42113645,-,9,4,13,known,chr11:42110894-42113645
sample_3_Aligned.sortedByCoord.out,chr12,22767369,22776857,+,5,2,7,novel,chr12:22767369-22776857
sample_3_Aligned.sortedByCoord.out,chr10,28165467,28166051,+,16,2,18,known,chr10:28165467-28166051
sample_3_Aligned.sortedByCoord.out,chr3,35004536,35010456,-,10,0,10,known,chr3:35004536-35010456
sample_3_Aligned.sortedByCoord.out,chr16,37157413,37158751,+,12,1,13,novel,chr16:37157413-37158751
sample_3_Aligned.sortedByCoord.out,chr19,43286199,43291457,-,4,4,8,known,chr19:43286199-43291457
sample_3_Aligned.sortedByCoord.out,chr18,39101334,39109642,-,10,1,11,known,chr18:39101334-39109642
sample_3_Aligned.sortedByCoord.out,chr18,4168352,4169824,-,13,1,14,known,chr18:4168352-4169824
sample_3_Aligned.sortedByCoord.out,chr12,45629346,45633989,-,9,1,10,known,chr12:45629346-45633989
sample_3_Aligned.sortedByCoord.out,chr10,28265219,28267204,-,6,3,9,known,chr10:28265219-28267204
sample_3_Aligned.sortedByCoord.out,chr16,10721698,10725440,-,8,2,10,known,chr16:10721698-10725440
sample_3_Aligned.sortedByCoord.out,chr15,25190785,25196346,-,11,0,11,known,chr15:25190785-25196346
sample_3_Aligned.sortedByCoord.out,chr1,1426831,1431650,-,8,2,10,known,chr1:1426831-1431650
sample_3_Aligned.sortedByCoord.out,chr16,42979987,42986770,+,8,0,8,known,chr16:42979987-42986770
sample_3_Aligned.sortedByCoord.out,chr5,6660832,6667761,+,13,2,15,known,chr5:6660832-6667761
sample_3_Aligned.sortedByCoord.out,chr10,29713636,29722120,+,14,4,18,known,chr10:29713636-29722120
sample_3_Aligned.sortedByCoord.out,chr19,42477160,42481051,-,8,1,9,known,chr19:42477160-42481051
sample_3_Aligned.sortedByCoord.out,chr9,31348396,31348949,+,10,4,14,known,chr9:31348396-31348949
sample_3_Aligned.sortedByCoord.out,chr17,17175148,17179140,+,8,4,12,known,chr17:17175148-17179140
sample_3_Aligned.sortedByCoord.out,chr10,36195392,36200675,+,14,1,15,novel,chr10:36195392-36200675
sample_3_Aligned.sortedByCoord.out,chr12,42574067,42578478,-,8,3,11,known,chr12:42574067-42578478
sample_3_Aligned.sortedByCoord.out,chr3,40479740,40483966,-,9,1,10,novel,chr3:40479740-40483966
sample_3_Aligned.sortedByCoord.out,chr6,47335192,47343937,-,6,2,8,known,chr6:47335192-47343937
sample_3_Aligned.sortedByCoord.out,chr20,25165145,25168579,+,9,2,11,known,chr20:25165145-25168579
sample_3_Aligned.sortedByCoord.out,chr18,9841357,9844439,-,10,1,11,known,chr18:9841357-9844439
sample_3_Aligned.sortedByCoord.out,chr8,24510461,24514190,-,10,3,13,known,chr8:24510461-24514190
sample_3_Aligned.sortedByCoord.out,chr5,14557350,14565988,-,5,3,8,known,chr5:14557350-14565988
sample_3_Aligned.sortedByCoord.out,chr20,38706734,38709735,-,9,5,14,known,chr20:38706734-38709735
sample_3_Aligned.sortedByCoord.out,chr21,11768868,11773343,+,11,3,14,known,chr21:11768868-11773343
sample_3_Aligned.sortedByCoord.out,chr2,32527140,32535779,-,13,2,15,novel,chr2:32527140-32535779
sample_3_Aligned.sortedByCoord.out,chr13,36193819,36200424,+,12,1,13,novel,chr13:36193819-36200424
sample_3_Aligned.sortedByCoord.out,chr14,5972710,5975501,-,9,1,10,known,chr14:5972710-5975501
sample_3_Aligned.sortedByCoord.out,chr21,21702851,21712493,-,13,5,18,known,chr21:21702851-21712493
sample_3_Aligned.sortedByCoord.out,chr19,13405062,13414690,-,10,3,13,known,chr19:13405062-13414690
sample_3_Aligned.sortedByCoord.out,chr19,12781442,12782385,+,16,3,19,known,chr19:12781442-12782385
sample_3_Aligned.sortedByCoord.out,chr2,34710902,34715347,-,9,1,10,known,chr2:34710902-34715347
sample_3_Aligned.sortedByCoord.out,chr17,7937764,7947117,-,11,6,17,known,chr17:7937764-7947117
sample_3_Aligned.sortedByCoord.out,chr12,38889736,38897046,+,6,1,7,known,chr12:38889736-38897046
sample_3_Aligned.sortedByCoord.out,chr10,38901172,38903569,-,8,1,9,novel,chr10:38901172-38903569
sample_3_Aligned.sortedByCoord.out,chr4,1803917,1808984,+,10,4,14,novel,chr4:1803917-1808984
sample_3_Aligned.sortedByCoord.out,chr6,3664084,3665423,-,13,2,15,known,chr6:3664084-3665423
sample_3_Aligned.sortedByCoord.out,chr10,4333495,4342748,-,10,0,10,known,chr10:4333495-4342748
sample_3_Aligned.sortedByCoord.out,chr2,9117254,9121573,+,16,2,18,known,chr2:9117254-9121573
sample_3_Aligned.sortedByCoord.out,chr14,22622895,22629104,-,15,3,18,known,chr14:22622895-22629104
sample_3_Aligned.sortedByCoord.out,chr1,24341001,24342248,+,10,2,12,known,chr1:24341001-24342248
sample_3_Aligned.sortedByCoord.out,chr7,19347525,19348383,-,15,5,20,known,chr7:19347525-19348383
sample_3_Aligned.sortedByCoord.out,chr9,33950014,33952190,+,8,1,9,novel,chr9:33950014-33952190
sample_3_Aligned.sortedByCoord.out,chr16,10553198,10558170,-,14,3,17,novel,chr16:10553198-10558170
sample_3_Aligned.sortedByCoord.out,chr7,14188975,14198220,+,10,1,11,known,chr7:14188975-14198220
sample_3_Aligned.sortedByCoord.out,chr22,15938072,15947790,+,3,4,7,novel,chr22:15938072-15947790
sample_3_Aligned.sortedByCoord.out,chr12,3310230,3313087,+,11,0,11,known,chr12:3310230-3313087
sample_3_Aligned.sortedByCoord.out,chr22,19553684,19556554,-,10,3,13,known,chr22:19553684-19556554
sample_3_Aligned.sortedByCoord.out,chr19,44436265,44438982,-,10,3,13,known,chr19:44436265-44438982
sample_3_Aligned.sortedByCoord.out,chr18,14459074,14467127,+,9,2,11,known,chr18:14459074-14467127
sample_3_Aligned.sortedByCoord.out,chr4,28081327,28090841,+,10,2,12,known,chr4:28081327-28090841
sample_3_Aligned.sortedByCoord.out,chr18,29957507,29962798,+,6,1,7,known,chr18:29957507-29962798
sample_3_Aligned.sortedByCoord.out,chr6,39958469,39964691,+,14,1,15,known,chr6:39958469-39964691
sample_3_Aligned.sortedByCoord.out,chr16,6245003,6253308,+,8,2,10,known,chr16:6245003-6253308
sample_3_Aligned.sortedByCoord.out,chr13,17618448,17625615,-,11,2,13,known,chr13:17618448-17625615
sample_3_Aligned.sortedByCoord.out,chr3,7903442,7905870,-,8,1,9,known,chr3:7903442-7905870
sample_3_Aligned.sortedByCoord.out,chr1,39727496,39731734,+,10,2,12,known,chr1:39727496-39731734
sample_3_Aligned.sortedByCoord.out,chr12,9278282,9285800,+,8,4,12,known,chr12:9278282-9285800
sample_3_Aligned.sortedByCoord.out,chr17,24390156,24398016,+,8,1,9,known,chr17:24390156-24398016
sample_3_Aligned.sortedByCoord.out,chr19,49968756,49969995,+,10,3,13,known,chr19:49968756-49969995
sample_3_Aligned.sortedByCoord.out,chr14,21320285,21323447,+,9,3,12,known,chr14:21320285-21323447
sample_3_Aligned.sortedByCoord.out,chr13,29246761,29253475,-,9,1,10,known,chr13:29246761-29253475
sample_3_Aligned.sortedByCoord.out,chr17,30051301,30052992,+,11,1,12,known,chr17:30051301-30052992
sample_3_Aligned.sortedByCoord.out,chr20,20555778,20556401,+,7,0,7,novel,chr20:20555778-20556401
sample_3_Aligned.sortedByCoord.out,chr13,40881287,40885608,+,12,4,16,known,chr13:40881287-40885608
sample_3_Aligned.sortedByCoord.out,chr21,18795453,18797514,+,14,4,18,novel,chr21:18795453-18797514
sample_3_Aligned.sortedByCoord.out,chr12,28468303,28471530,-,15,4,19,known,chr12:28468303-28471530
sample_3_Aligned.sortedByCoord.out,chr10,6781676,6784528,+,11,0,11,known,chr10:6781676-6784528
sample_3_Aligned.sortedByCoord.out,chr9,15128682,15131807,-,6,0,6,known,chr9:15128682-15131807
sample_3_Aligned.sortedByCoord.out,chr9,5824196,5831468,+,11,5,16,known,chr9:5824196-5831468
sample_3_Aligned.sortedByCoord.out,chr4,16127226,16133708,-,11,1,12,known,chr4:16127226-16133708
sample_3_Aligned.sortedByCoord.out,chr5,21486942,21490635,+,7,1,8,known,chr5:21486942-21490635
sample_3_Aligned.sortedByCoord.out,chr19,2835338,2835978,-,6,2,8,novel,chr19:2835338-2835978
sample_3_Aligned.sortedByCoord.out,chr21,32690105,32695291,-,3,1,4,known,chr21:32690105-32695291
sample_3_Aligned.sortedByCoord.out,chr18,13959482,13960467,-,7,0,7,novel,chr18:13959482-13960467
sample_3_Aligned.sortedByCoord.out,chr11,9960732,9964576,-,14,2,16,known,chr11:9960732-9964576
sample_3_Aligned.sortedByCoord.out,chr16,11929061,11936652,+,14,2,16,novel,chr16:11929061-11936652
sample_3_Aligned.sortedByCoord.out,chr4,12721297,12725737,+,9,3,12,novel,chr4:12721297-12725737
sample_3_Aligned.sortedByCoord.out,chr11,29038185,29042137,-,15,2,17,known,chr11:29038185-29042137
sample_3_Aligned.sortedByCoord.out,chr5,9596962,9597669,-,10,3,13,known,chr5:9596962-9597669
sample_3_Aligned.sortedByCoord.out,chr3,13242911,13252722,+,9,3,12,known,chr3:13242911-13252722
sample_3_Aligned.sortedByCoord.out,chr11,17185965,17194784,+,15,1,16,known,chr11:17185965-17194784
sample_3_Aligned.sortedByCoord.out,chr1,4776917,4784230,+,9,2,11,novel,chr1:4776917-4784230
sample_3_Aligned.sortedByCoord.out,chr18,23679643,23686848,+,5,1,6,novel,chr18:23679643-23686848
sample_3_Aligned.sortedByCoord.out,chr9,44171442,44173380,+,9,1,10,known,chr9:44171442-44173380
sample_3_Aligned.sortedByCoord.out,chr17,27249642,27251714,-,14,0,14,known,chr17:27249642-27251714
sample_3_Aligned.sortedByCoord.out,chr1,26176330,26179108,+,5,5,10,novel,chr1:26176330-26179108
sample_3_Aligned.sortedByCoord.out,chr12,20700389,20706425,-,12,4,16,known,chr12:20700389-20706425
sample_3_Aligned.sortedByCoord.out,chr7,38233714,38239502,+,13,1,14,known,chr7:38233714-38239502
sample_3_Aligned.sortedByCoord.out,chr11,3900557,3908981,+,9,3,12,known,chr11:3900557-3908981
sample_3_Aligned.sortedByCoord.out,chr9,21170169,21175156,-,10,3,13,known,chr9:21170169-21175156
sample_3_Aligned.sortedByCoord.out,chr22,22106121,22115498,+,17,0,17,known,chr22:22106121-22115498
sample_3_Aligned.sortedByCoord.out,chr13,26304658,26312023,+,9,5,14,known,chr13:26304658-26312023
sample_3_Aligned.sortedByCoord.out,chr3,26039591,26042219,+,5,0,5,novel,chr3:26039591-26042219
sample_3_Aligned.sortedByCoord.out,chr19,42483616,42485796,-,6,3,9,known,chr19:42483616-42485796
sample_3_Aligned.sortedByCoord.out,chr16,19593100,19601919,+,8,2,10,known,chr16:19593100-19601919
sample_3_Aligned.sortedByCoord.out,chr18,13118720,13119505,+,12,1,13,known,chr18:13118720-13119505
sample_3_Aligned.sortedByCoord.out,chr9,17819815,17821751,-,8,2,10,known,chr9:17819815-17821751
sample_3_Aligned.sortedByCoord.out,chr11,4095640,4097990,-,6,2,8,known,chr11:4095640-4097990
sample_3_Aligned.sortedByCoord.out,chr8,3918569,3922716,-,9,1,10,novel,chr8:3918569-3922716
sample_3_Aligned.sortedByCoord.out,chr14,47913729,47921553,+,7,3,10,known,chr14:47913729-47921553
sample_3_Aligned.sortedByCoord.out,chr13,33126488,33132433,-,6,0,6,known,chr13:33126488-33132433
sample_3_Aligned.sortedByCoord.out,chr11,39046209,39055569,+,8,1,9,novel,chr11:39046209-39055569
sample_3_Aligned.sortedByCoord.out,chr10,8742689,8746084,-,12,0,12,novel,chr10:8742689-8746084
sample_3_Aligned.sortedByCoord.out,chr4,1327080,1328899,-,6,0,6,known,chr4:1327080-1328899
sample_3_Aligned.sortedByCoord.out,chr5,31788189,31797825,-,10,3,13,known,chr5:31788189-31797825
sample_3_Aligned.sortedByCoord.out,chr1,8044216,8052846,-,7,1,8,known,chr1:8044216-8052846
sample_3_Aligned.sortedByCoord.out,chr5,21860685,21867998,+,14,2,16,known,chr5:21860685-21867998
sample_3_Aligned.sortedByCoord.out,chr16,12954582,12956381,+,8,3,11,novel,chr16:12954582-12956381
sample_3_Aligned.sortedByCoord.out,chr14,28988798,28990134,+,14,0,14,known,chr14:28988798-28990134
sample_3_Aligned.sortedByCoord.out,chr10,12410837,12419143,+,9,3,12,known,chr10:12410837-12419143
sample_3_Aligned.sortedByCoord.out,chr4,38080242,38085586,+,10,7,17,known,chr4:38080242-38085586
sample_3_Aligned.sortedByCoord.out,chr18,17769779,17772594,+,9,2,11,known,chr18:17769779-17772594
sample_3_Aligned.sortedByCoord.out,chr1,39766607,39772594,-,6,0,6,known,chr1:39766607-39772594
sample_3_Aligned.sortedByCoord.out,chr1,18498627,18501916,+,8,3,11,known,chr1:18498627-18501916
sample_3_Aligned.sortedByCoord.out,chr20,2432599,2442507,+,8,1,9,known,chr20:2432599-2442507
sample_3_Aligned.sortedByCoord.out,chr4,36150134,36153982,-,8,2,10,novel,chr4:36150134-36153982
sample_3_Aligned.sortedByCoord.out,chr9,10571436,10578450,-,14,0,14,novel,chr9:10571436-10578450
sample_3_Aligned.sortedByCoord.out,chr9,11769998,11777508,-,9,6,15,novel,chr9:11769998-11777508
sample_3_Aligned.sortedByCoord.out,chr11,11941021,11945716,-,9,1,10,known,chr11:11941021-11945716
sample_3_Aligned.sortedByCoord.out,chr18,15796478,15804109,+,12,4,16,known,chr18:15796478-15804109
sample_3_Aligned.sortedByCoord.out,chr16,32667887,32671051,-,10,3,13,known,chr16:32667887-32671051
sample_3_Aligned.sortedByCoord.out,chr2,11101210,11105450,+,6,2,8,known,chr2:11101210-11105450
sample_3_Aligned.sortedByCoord.out,chr18,1724478,1731947,+,11,1,12,known,chr18:1724478-1731947
sample_3_Aligned.sortedByCoord.out,chr6,40438072,40441353,+,5,2,7,known,chr6:40438072-40441353
sample_3_Aligned.sortedByCoord.out,chr2,38227950,38237782,+,10,3,13,novel,chr2:38227950-38237782
sample_3_Aligned.sortedByCoord.out,chr13,3211900,3218045,-,10,0,10,known,chr13:3211900-3218045
sample_3_Aligned.sortedByCoord.out,chr8,13506445,13508455,-,12,4,16,known,chr8:13506445-13508455
sample_3_Aligned.sortedByCoord.out,chr10,46375853,46382154,-,8,1,9,known,chr10:46375853-46382154
sample_3_Aligned.sortedByCoord.out,chr17,2494616,2503776,-,4,2,6,known,chr17:2494616-2503776
sample_3_Aligned.sortedByCoord.out,chr4,7875762,7881054,+,6,3,9,known,chr4:7875762-7881054
sample_3_Aligned.sortedByCoord.out,chr17,25455787,25461807,-,7,2,9,known,chr17:25455787-25461807
sample_3_Aligned.sortedByCoord.out,chr15,44891270,44897571,+,12,2,14,known,chr15:44891270-44897571
sample_3_Aligned.sortedByCoord.out,chr12,4456648,4461916,+,12,1,13,known,chr12:4456648-4461916
sample_3_Aligned.sortedByCoord.out,chr19,15914593,15920570,+,8,4,12,known,chr19:15914593-15920570
sample_3_Aligned.sortedByCoord.out,chr10,2220940,2225178,-,13,4,17,known,chr10:2220940-2225178
sample_3_Aligned.sortedByCoord.out,chr9,47220587,47225567,-,12,1,13,known,chr9:47220587-47225567
sample_3_Aligned.sortedByCoord.out,chr19,48366071,48372239,-,4,2,6,known,chr19:48366071-48372239
sample_3_Aligned.sortedByCoord.out,chr17,21167583,21172388,-,11,2,13,known,chr17:21167583-21172388
sample_3_Aligned.sortedByCoord.out,chr7,17716843,17722935,-,9,2,11,known,chr7:17716843-17722935
sample_3_Aligned.sortedByCoord.out,chr12,16456102,16458408,+,9,0,9,known,chr12:16456102-16458408
sample_3_Aligned.sortedByCoord.out,chr15,43280413,43288612,-,13,2,15,known,chr15:43280413-43288612
sample_3_Aligned.sortedByCoord.out,chr22,8759269,8764205,-,10,2,12,known,chr22:8759269-8764205
sample_3_Aligned.sortedByCoord.out,chr16,46564173,46569181,+,8,4,12,known,chr16:46564173-46569181
sample_3_Aligned.sortedByCoord.out,chr2,26540282,26541858,-,10,1,11,known,chr2:26540282-26541858
sample_3_Aligned.sortedByCoord.out,chr19,47012056,47016681,-,15,5,20,known,chr19:47012056-47016681
sample_3_Aligned.sortedByCoord.out,chr21,9440129,9440528,-,12,2,14,known,chr21:9440129-9440528
sample_3_Aligned.sortedByCoord.out,chr16,24906322,24916186,+,14,1,15,known,chr16:24906322-24916186
sample_3_Aligned.sortedByCoord.out,chr1,47050977,47060213,-,9,2,11,novel,chr1:47050977-47060213
sample_3_Aligned.sortedByCoord.out,chr1,43700461,43705332,+,12,1,13,known,chr1:43700461-43705332
sample_3_Aligned.sortedByCoord.out,chr9,2231095,2240844,+,6,3,9,known,chr9:2231095-2240844
sample_3_Aligned.sortedByCoord.out,chr19,19333315,19334086,-,9,2,11,known,chr19:19333315-19334086
sample_3_Aligned.sortedByCoord.out,chr17,16197791,16203952,+,10,0,10,known,chr17:16197791-16203952
sample_3_Aligned.sortedByCoord.out,chr6,26953613,26954545,+,13,2,15,known,chr6:26953613-26954545
sample_3_Aligned.sortedByCoord.out,chr3,28766262,28770236,-,14,1,15,known,chr3:28766262-28770236
sample_3_Aligned.sortedByCoord.out,chr14,12955932,12960099,+,6,5,11,known,chr14:12955932-12960099
sample_3_Aligned.sortedByCoord.out,chr10,28514069,28517183,-,9,2,11,known,chr10:28514069-28517183
sample_3_Aligned.sortedByCoord.out,chr9,14844275,14844940,-,11,3,14,novel,chr9:14844275-14844940
sample_3_Aligned.sortedByCoord.out,chr7,26353756,26356219,+,7,5,12,known,chr7:26353756-26356219
sample_3_Aligned.sortedByCoord.out,chr16,48088370,48097911,+,13,1,14,novel,chr16:48088370-48097911
sample_3_Aligned.sortedByCoord.out,chr19,5868432,5868971,+,10,2,12,novel,chr19:5868432-5868971
sample_3_Aligned.sortedByCoord.out,chr1,22615057,22621939,+,14,1,15,known,chr1:22615057-22621939
sample_3_Aligned.sortedByCoord.out,chr5,31013812,31020902,+,7,1,8,known,chr5:31013812-31020902
sample_3_Aligned.sortedByCoord.out,chr16,6922431,6926960,+,8,0,8,known,chr16:6922431-6926960
sample_3_Aligned.sortedByCoord.out,chr20,11512296,11514566,+,14,0,14,novel,chr20:11512296-11514566
sample_3_Aligned.sortedByCoord.out,chr6,43410574,43413686,-,11,1,12,known,chr6:43410574-43413686
sample_3_Aligned.sortedByCoord.out,chr22,43187501,43190708,-,9,4,13,known,chr22:43187501-43190708
sample_3_Aligned.sortedByCoord.out,chr11,49230726,49236256,-,7,6,13,novel,chr11:49230726-49236256
sample_3_Aligned.sortedByCoord.out,chr5,43674976,43681255,+,14,1,15,known,chr5:43674976-43681255
sample_3_Aligned.sortedByCoord.out,chr19,18331832,18332397,-,9,1,10,known,chr19:18331832-18332397
sample_3_Aligned.sortedByCoord.out,chr3,10784402,10789459,-,7,3,10,known,chr3:10784402-10789459
sample_3_Aligned.sortedByCoord.out,chr9,2956546,2957869,+,4,1,5,known,chr9:2956546-2957869
sample_3_Aligned.sortedByCoord.out,chr6,27977270,27979385,-,9,5,14,known,chr6:27977270-27979385
sample_3_Aligned.sortedByCoord.out,chr12,7383640,7393144,+,11,1,12,known,chr12:7383640-7393144
sample_3_Aligned.sortedByCoord.out,chr19,39770807,39777043,+,10,0,10,novel,chr19:39770807-39777043
sample_3_Aligned.sortedByCoord.out,chr2,17391624,17393138,+,5,1,6,known,chr2:17391624-17393138
sample_3_Aligned.sortedByCoord.out,chr12,31684771,31691152,-,10,4,14,known,chr12:31684771-31691152
sample_3_Aligned.sortedByCoord.out,chr6,4740701,4748942,+,9,1,10,known,chr6:4740701-4748942
sample_3_Aligned.sortedByCoord.out,chr22,5489375,5498846,-,16,4,20,known,chr22:5489375-5498846
sample_3_Aligned.sortedByCoord.out,chr8,29521670,29527088,+,13,0,13,known,chr8:29521670-29527088
sample_3_Aligned.sortedByCoord.out,chr8,14824270,14824958,+,8,3,11,known,chr8:14824270-14824958
sample_3_Aligned.sortedByCoord.out,chr16,29876629,29880893,-,8,2,10,known,chr16:29876629-29880893
sample_3_Aligned.sortedByCoord.out,chr18,1190922,1192006,-,20,2,22,novel,chr18:1190922-1192006
sample_3_Aligned.sortedByCoord.out,chr19,31357630,31366114,-,7,0,7,known,chr19:31357630-31366114
sample_3_Aligned.sortedByCoord.out,chr14,4000615,4001018,-,15,0,15,novel,chr14:4000615-4001018
sample_3_Aligned.sortedByCoord.out,chr11,46868109,46875708,-,11,3,14,known,chr11:46868109-46875708
sample_3_Aligned.sortedByCoord.out,chr2,26356277,26364573,-,8,2,10,novel,chr2:26356277-26364573
sample_3_Aligned.sortedByCoord.out,chr10,49004579,49008421,-,9,0,9,novel,chr10:49004579-49008421
sample_3_Aligned.sortedByCoord.out,chr3,16742839,16752345,-,8,3,11,known,chr3:16742839-16752345
sample_3_Aligned.sortedByCoord.out,chr3,5466293,5468729,+,4,3,7,known,chr3:5466293-5468729
sample_3_Aligned.sortedByCoord.out,chr12,45133408,45138393,-,11,1,12,known,chr12:45133408-45138393
sample_3_Aligned.sortedByCoord.out,chr19,29175491,29179952,+,11,2,13,known,chr19:29175491-29179952
sample_3_Aligned.sortedByCoord.out,chr12,45938617,45940141,+,4,0,4,known,chr12:45938617-45940141
sample_3_Aligned.sortedByCoord.out,chr19,21200145,21206956,+,10,0,10,known,chr19:21200145-21206956
sample_3_Aligned.sortedByCoord.out,chr9,1305648,1312971,-,7,3,10,known,chr9:1305648-1312971
sample_3_Aligned.sortedByCoord.out,chr4,25100270,25103232,-,14,3,17,known,chr4:25100270-25103232
sample_3_Aligned.sortedByCoord.out,chr15,34568392,34572634,-,8,2,10,known,chr15:34568392-34572634
sample_3_Aligned.sortedByCoord.out,chr20,45838010,45845832,-,10,1,11,novel,chr20:45838010-45845832
sample_3_Aligned.sortedByCoord.out,chr22,40730151,40731630,+,14,1,15,known,chr22:40730151-40731630
sample_3_Aligned.sortedByCoord.out,chr2,16822084,16825962,-,8,1,9,known,chr2:16822084-16825962
sample_3_Aligned.sortedByCoord.out,chr17,39011560,39011965,+,6,1,7,known,chr17:39011560-39011965
sample_3_Aligned.sortedByCoord.out,chr20,23058638,23062067,-,9,1,10,known,chr20:23058638-23062067
sample_3_Aligned.sortedByCoord.out,chr11,6208403,6212919,+,7,3,10,known,chr11:6208403-6212919
sample_3_Aligned.sortedByCoord.out,chr19,1696187,1700460,-,13,3,16,known,chr19:1696187-1700460
sample_3_Aligned.sortedByCoord.out,chr15,20918855,20924748,+,17,3,20,known,chr15:20918855-20924748
sample_3_Aligned.sortedByCoord.out,chr16,40515641,40519307,+,7,3,10,known,chr16:40515641-40519307
sample_3_Aligned.sortedByCoord.out,chr20,19878460,19887044,-,12,1,13,known,chr20:19878460-19887044
sample_3_Aligned.sortedByCoord.out,chr13,17041748,17042101,+,16,2,18,known,chr13:17041748-17042101
sample_3_Aligned.sortedByCoord.out,chr9,39075302,39081314,+,7,1,8,known,chr9:39075302-39081314
sample_3_Aligned.sortedByCoord.out,chr7,25614564,25622595,-,10,4,14,known,chr7:25614564-25622595
sample_3_Aligned.sortedByCoord.out,chr9,36315892,36323880,-,10,1,11,known,chr9:36315892-36323880
sample_3_Aligned.sortedByCoord.out,chr9,18012941,18013722,-,10,1,11,known,chr9:18012941-18013722
sample_3_Aligned.sortedByCoord.out,chr20,9504393,9513411,+,12,3,15,known,chr20:9504393-9513411
sample_3_Aligned.sortedByCoord.out,chr21,6723383,6731227,+,10,0,10,known,chr21:6723383-6731227
sample_3_Aligned.sortedByCoord.out,chr16,29296840,29306763,-,8,2,10,known,chr16:29296840-29306763
sample_3_Aligned.sortedByCoord.out,chr12,1137753,1144684,+,6,0,6,known,chr12:1137753-1144684
sample_3_Aligned.sortedByCoord.out,chr6,29228884,29237458,+,11,0,11,known,chr6:29228884-29237458
sample_3_Aligned.sortedByCoord.out,chr9,33773420,33775550,+,8,5,13,known,chr9:33773420-33775550
sample_3_Aligned.sortedByCoord.out,chr15,37618346,37623337,+,8,5,13,novel,chr15:37618346-37623337
sample_3_Aligned.sortedByCoord.out,chr6,8840965,8842003,-,11,3,14,novel,chr6:8840965-8842003
sample_3_Aligned.sortedByCoord.out,chr22,24623125,24625057,-,11,0,11,novel,chr22:24623125-24625057
sample_3_Aligned.sortedByCoord.out,chr5,36224984,36229641,+,11,3,14,novel,chr5:36224984-36229641
sample_3_Aligned.sortedByCoord.out,chr18,10841645,10845055,-,12,4,16,novel,chr18:10841645-10845055
sample_3_Aligned.sortedByCoord.out,chr13,14826222,14827272,+,9,0,9,known,chr13:14826222-14827272
sample_3_Aligned.sortedByCoord.out,chr18,19922859,19931216,-,12,1,13,novel,chr18:19922859-19931216
sample_3_Aligned.sortedByCoord.out,chr22,3182684,3189806,-,9,5,14,known,chr22:3182684-3189806
sample_3_Aligned.sortedByCoord.out,chr19,1378493,1384086,+,16,1,17,known,chr19:1378493-1384086
sample_3_Aligned.sortedByCoord.out,chr11,21377303,21387016,-,13,1,14,known,chr11:21377303-21387016
sample_3_Aligned.sortedByCoord.out,chr3,41500027,41506156,-,12,3,15,known,chr3:41500027-41506156
sample_3_Aligned.sortedByCoord.out,chr9,9950074,9951302,-,12,5,17,known,chr9:9950074-9951302
sample_3_Aligned.sortedByCoord.out,chr11,12069229,12070529,+,8,1,9,known,chr11:12069229-12070529
sample_3_Aligned.sortedByCoord.out,chr5,49789566,49790098,+,6,0,6,known,chr5:49789566-49790098
sample_3_Aligned.sortedByCoord.out,chr21,49184867,49185790,+,9,1,10,novel,chr21:49184867-49185790
sample_3_Aligned.sortedByCoord.out,chr19,4835686,4839565,+,5,0,5,known,chr19:4835686-4839565
sample_3_Aligned.sortedByCoord.out,chr19,11248571,11257129,-,9,0,9,known,chr19:11248571-11257129
sample_3_Aligned.sortedByCoord.out,chr8,19951696,19961350,+,11,2,13,known,chr8:19951696-19961350
sample_3_Aligned.sortedByCoord.out,chr5,23355664,23356657,+,6,1,7,known,chr5:23355664-23356657
sample_3_Aligned.sortedByCoord.out,chr17,49404131,49413063,+,13,4,17,known,chr17:49404131-49413063
sample_3_Aligned.sortedByCoord.out,chr3,31794967,31799406,-,14,2,16,known,chr3:31794967-31799406
sample_3_Aligned.sortedByCoord.out,chr6,10998480,11000266,+,6,3,9,known,chr6:10998480-11000266
sample_3_Aligned.sortedByCoord.out,chr10,3758818,3759988,-,10,3,13,novel,chr10:3758818-3759988
sample_3_Aligned.sortedByCoord.out,chr5,11564300,11573039,+,7,0,7,known,chr5:11564300-11573039
sample_3_Aligned.sortedByCoord.out,chr21,3959195,3968936,-,11,0,11,known,chr21:3959195-3968936
sample_3_Aligned.sortedByCoord.out,chr6,43577592,43578792,+,14,2,16,known,chr6:43577592-43578792
sample_3_Aligned.sortedByCoord.out,chr14,32680983,32690312,+,9,3,12,novel,chr14:32680983-32690312
sample_3_Aligned.sortedByCoord.out,chr17,35700990,35701339,-,9,3,12,novel,chr17:35700990-35701339
sample_3_Aligned.sortedByCoord.out,chr18,33231882,33240424,+,18,1,19,known,chr18:33231882-33240424
sample_3_Aligned.sortedByCoord.out,chr4,15400929,15406890,-,13,2,15,known,chr4:15400929-15406890
sample_3_Aligned.sortedByCoord.out,chr20,48453789,48459267,-,9,1,10,known,chr20:48453789-48459267
sample_3_Aligned.sortedByCoord.out,chr18,40707839,40715225,-,11,3,14,known,chr18:40707839-40715225
sample_3_Aligned.sortedByCoord.out,chr15,6349641,6358405,-,9,2,11,known,chr15:6349641-6358405
sample_3_Aligned.sortedByCoord.out,chr15,47728804,47735126,-,12,4,16,novel,chr15:47728804-47735126
sample_3_Aligned.sortedByCoord.out,chr19,3381026,3383302,+,8,4,12,known,chr19:3381026-3383302
sample_3_Aligned.sortedByCoord.out,chr6,33661164,33670735,-,14,2,16,known,chr6:33661164-33670735
sample_3_Aligned.sortedByCoord.out,chr3,32025207,32033922,-,10,2,12,novel,chr3:32025207-32033922
sample_3_Aligned.sortedByCoord.out,chr9,33441952,33448930,-,9,1,10,novel,chr9:33441952-33448930
sample_3_Aligned.sortedByCoord.out,chr18,35039507,35045716,-,11,0,11,known,chr18:35039507-35045716
sample_3_Aligned.sortedByCoord.out,chr6,2583067,2585544,+,14,2,16,known,chr6:2583067-2585544
sample_3_Aligned.sortedByCoord.out,chr7,29772187,29778212,-,12,0,12,novel,chr7:29772187-29778212
sample_3_Aligned.sortedByCoord.out,chr13,16943626,16952544,+,9,1,10,known,chr13:16943626-16952544
sample_3_Aligned.sortedByCoord.out,chr21,28806454,28816183,+,8,1,9,known,chr21:28806454-28816183
sample_3_Aligned.sortedByCoord.out,chr2,29262443,29268932,-,9,1,10,known,chr2:29262443-29268932
sample_3_Aligned.sortedByCoord.out,chr18,33693402,33695327,-,9,1,10,known,chr18:33693402-33695327
sample_3_Aligned.sortedByCoord.out,chr21,31029249,31035769,-,8,1,9,novel,chr21:31029249-31035769
sample_3_Aligned.sortedByCoord.out,chr19,20264505,20265974,-,12,3,15,known,chr19:20264505-20265974
sample_3_Aligned.sortedByCoord.out,chr10,37327026,37332172,+,12,3,15,known,chr10:37327026-37332172
sample_3_Aligned.sortedByCoord.out,chr17,3501556,3506186,-,6,1,7,known,chr17:3501556-3506186
sample_3_Aligned.sortedByCoord.out,chr13,31176545,31185945,-,14,1,15,known,chr13:31176545-31185945
sample_3_Aligned.sortedByCoord.out,chr1,38766246,38775653,+,9,3,12,novel,chr1:38766246-38775653
sample_3_Aligned.sortedByCoord.out,chr4,21318300,21321432,-,8,1,9,known,chr4:21318300-21321432
sample_3_Aligned.sortedByCoord.out,chr11,45160091,45160653,+,11,1,12,known,chr11:45160091-45160653
sample_3_Aligned.sortedByCoord.out,chr7,29640473,29645658,-,15,2,17,known,chr7:29640473-29645658
sample_3_Aligned.sortedByCoord.out,chr1,30510270,30510442,-,14,0,14,known,chr1:30510270-30510442
sample_3_Aligned.sortedByCoord.out,chr16,16897289,16904964,+,8,3,11,known,chr16:16897289-16904964
sample_3_Aligned.sortedByCoord.out,chr11,9549787,9553988,+,7,5,12,novel,chr11:9549787-9553988
sample_3_Aligned.sortedByCoord.out,chr2,23737889,23743340,-,9,1,10,known,chr2:23737889-23743340
sample_3_Aligned.sortedByCoord.out,chr17,41039885,41044559,+,3,6,9,known,chr17:41039885-41044559
sample_3_Aligned.sortedByCoord.out,chr5,7205930,7207312,+,10,2,12,known,chr5:7205930-7207312
sample_3_Aligned.sortedByCoord.out,chr18,19131493,19138428,+,12,0,12,known,chr18:19131493-19138428
sample_3_Aligned.sortedByCoord.out,chr10,29125817,29129530,+,12,2,14,known,chr10:29125817-29129530
sample_3_Aligned.sortedByCoord.out,chr10,30444134,30451461,+,12,1,13,known,chr10:30444134-30451461
sample_3_Aligned.sortedByCoord.out,chr22,38886909,38892862,-,16,2,18,known,chr22:38886909-38892862
sample_3_Aligned.sortedByCoord.out,chr2,36529655,36534335,-,9,4,13,known,chr2:36529655-36534335
sample_3_Aligned.sortedByCoord.out,chr17,41765630,41772784,-,17,3,20,novel,chr17:41765630-41772784
sample_3_Aligned.sortedByCoord.out,chr9,38916184,38920572,-,9,2,11,known,chr9:38916184-38920572
sample_3_Aligned.sortedByCoord.out,chr22,49459626,49460053,-,16,0,16,known,chr22:49459626-49460053
sample_3_Aligned.sortedByCoord.out,chr10,30409007,30413775,-,8,5,13,known,chr10:30409007-30413775
sample_3_Aligned.sortedByCoord.out,chr19,35389629,35396100,+,8,0,8,novel,chr19:35389629-35396100
sample_3_Aligned.sortedByCoord.out,chr17,49878027,49884672,+,12,2,14,known,chr17:49878027-49884672
sample_3_Aligned.sortedByCoord.out,chr12,34221315,34227965,-,12,0,12,known,chr12:34221315-34227965
sample_3_Aligned.sortedByCoord.out,chr20,24756508,24763596,-,8,3,11,known,chr20:24756508-24763596
sample_3_Aligned.sortedByCoord.out,chr18,47961597,47967501,+,10,1,11,known,chr18:47961597-47967501
sample_3_Aligned.sortedByCoord.out,chr20,48134451,48135918,-,9,2,11,known,chr20:48134451-48135918
sample_3_Aligned.sortedByCoord.out,chr20,28905130,28908033,+,9,2,11,novel,chr20:28905130-28908033
sample_3_Aligned.sortedByCoord.out,chr20,30698015,30702418,+,9,1,10,known,chr20:30698015-30702418
sample_3_Aligned.sortedByCoord.out,chr5,14945003,14954973,+,6,5,11,known,chr5:14945003-14954973
sample_3_Aligned.sortedByCoord.out,chr7,20233106,20235908,+,8,0,8,known,chr7:20233106-20235908
sample_3_Aligned.sortedByCoord.out,chr15,5667765,5673545,+,6,4,10,known,chr15:5667765-5673545
sample_3_Aligned.sortedByCoord.out,chr3,6529425,6535114,+,11,1,12,known,chr3:6529425-6535114
sample_3_Aligned.sortedByCoord.out,chr5,33814328,33816814,+,5,2,7,known,chr5:33814328-33816814
sample_3_Aligned.sortedByCoord.out,chr18,13465680,13467173,+,8,2,10,known,chr18:13465680-13467173
sample_3_Aligned.sortedByCoord.out,chr7,2664418,2673232,-,8,1,9,novel,chr7:2664418-2673232
sample_3_Aligned.sortedByCoord.out,chr8,23061263,23067603,+,10,3,13,novel,chr8:23061263-23067603
sample_3_Aligned.sortedByCoord.out,chr7,49169144,49169912,+,9,0,9,known,chr7:49169144-49169912
sample_3_Aligned.sortedByCoord.out,chr4,11669206,11674718,+,12,2,14,known,chr4:11669206-11674718
sample_3_Aligned.sortedByCoord.out,chr14,5342936,5343492,+,12,0,12,novel,chr14:5342936-5343492
sample_3_Aligned.sortedByCoord.out,chr15,11775572,11775926,-,5,0,5,known,chr15:11775572-11775926
sample_3_Aligned.sortedByCoord.out,chr1,36857586,36860148,-,13,2,15,known,chr1:36857586-36860148
sample_3_Aligned.sortedByCoord.out,chr8,38616542,38620544,-,9,2,11,known,chr8:38616542-38620544
sample_3_Aligned.sortedByCoord.out,chr2,16663211,16669808,-,10,3,13,known,chr2:16663211-16669808
sample_3_Aligned.sortedByCoord.out,chr1,36107684,36110556,-,18,0,18,novel,chr1:36107684-36110556
sample_3_Aligned.sortedByCoord.out,chr18,28260853,28269522,+,9,2,11,known,chr18:28260853-28269522
sample_3_Aligned.sortedByCoord.out,chr2,1167254,1168311,+,7,2,9,novel,chr2:1167254-1168311
sample_3_Aligned.sortedByCoord.out,chr11,5499784,5502029,-,9,2,11,novel,chr11:5499784-5502029
sample_3_Aligned.sortedByCoord.out,chr19,29791398,29797992,-,12,1,13,known,chr19:29791398-29797992
sample_3_Aligned.sortedByCoord.out,chr10,41371297,41378065,-,10,0,10,known,chr10:41371297-41378065
sample_3_Aligned.sortedByCoord.out,chr8,19134433,19141011,-,10,2,12,novel,chr8:19134433-19141011
sample_3_Aligned.sortedByCoord.out,chr4,38947893,38949268,+,14,2,16,known,chr4:38947893-38949268
sample_3_Aligned.sortedByCoord.out,chr19,46007024,46008727,+,8,1,9,known,chr19:46007024-46008727
sample_3_Aligned.sortedByCoord.out,chr6,42584901,42587996,-,8,4,12,known,chr6:42584901-42587996
sample_3_Aligned.sortedByCoord.out,chr8,26070363,26077178,-,7,2,9,known,chr8:26070363-26077178
sample_3_Aligned.sortedByCoord.out,chr19,24570150,24573041,+,10,3,13,known,chr19:24570150-24573041
sample_3_Aligned.sortedByCoord.out,chr8,6063881,6072831,+,9,1,10,known,chr8:6063881-6072831
sample_3_Aligned.sortedByCoord.out,chr9,19208711,19210202,-,14,3,17,known,chr9:19208711-19210202
sample_3_Aligned.sortedByCoord.out,chr22,21658696,21665095,-,10,1,11,known,chr22:21658696-21665095
sample_3_Aligned.sortedByCoord.out,chr16,17723636,17731629,+,9,1,10,known,chr16:17723636-17731629
sample_3_Aligned.sortedByCoord.out,chr20,24754400,24763176,+,6,3,9,known,chr20:24754400-24763176
sample_3_Aligned.sortedByCoord.out,chr2,32935024,32943058,-,6,5,11,known,chr2:32935024-32943058
sample_3_Aligned.sortedByCoord.out,chr14,10612164,10618543,-,11,0,11,known,chr14:10612164-10618543
sample_3_Aligned.sortedByCoord.out,chr3,23893751,23903289,+,11,4,15,known,chr3:23893751-23903289
sample_3_Aligned.sortedByCoord.out,chr3,1600999,1602540,-,10,1,11,known,chr3:1600999-1602540
sample_3_Aligned.sortedByCoord.out,chr18,12592582,12593690,+,12,3,15,novel,chr18:12592582-12593690
sample_3_Aligned.sortedByCoord.out,chr17,23580551,23585317,-,12,2,14,known,chr17:23580551-23585317
sample_3_Aligned.sortedByCoord.out,chr22,44120791,44124821,+,6,1,7,known,chr22:44120791-44124821
sample_3_Aligned.sortedByCoord.out,chr4,33228878,33234268,+,9,1,10,novel,chr4:33228878-33234268
sample_3_Aligned.sortedByCoord.out,chr5,47263680,47267096,+,18,2,20,known,chr5:47263680-47267096
sample_3_Aligned.sortedByCoord.out,chr17,25026325,25035425,-,10,3,13,known,chr17:25026325-25035425
sample_3_Aligned.sortedByCoord.out,chr14,12979738,12984049,-,15,1,16,known,chr14:12979738-12984049
sample_3_Aligned.sortedByCoord.out,chr21,13963088,13965030,+,9,2,11,known,chr21:13963088-13965030
sample_3_Aligned.sortedByCoord.out,chr17,32205415,32211319,+,11,1,12,known,chr17:32205415-32211319
sample_3_Aligned.sortedByCoord.out,chr10,6419058,6420353,-,5,2,7,novel,chr10:6419058-6420353
sample_3_Aligned.sortedByCoord.out,chr7,17306404,17312278,+,11,4,15,known,chr7:17306404-17312278
sample_3_Aligned.sortedByCoord.out,chr2,3244253,3254216,+,8,1,9,known,chr2:3244253-3254216
sample_3_Aligned.sortedByCoord.out,chr17,3818666,3826577,-,12,1,13,known,chr17:3818666-3826577
sample_3_Aligned.sortedByCoord.out,chr11,18416157,18426107,-,8,0,8,novel,chr11:18416157-18426107
sample_3_Aligned.sortedByCoord.out,chr14,14065193,14068144,-,9,2,11,known,chr14:14065193-14068144
sample_3_Aligned.sortedByCoord.out,chr2,26813301,26822994,-,12,1,13,known,chr2:26813301-26822994
sample_3_Aligned.sortedByCoord.out,chr21,47339670,47339831,-,7,4,11,known,chr21:47339670-47339831
sample_3_Aligned.sortedByCoord.out,chr7,16195295,16204239,+,11,0,11,known,chr7:16195295-16204239
sample_3_Aligned.sortedByCoord.out,chr9,45016914,45022782,-,2,1,3,novel,chr9:45016914-45022782
sample_3_Aligned.sortedByCoord.out,chr22,11877700,11882341,-,7,2,9,known,chr22:11877700-11882341
sample_3_Aligned.sortedByCoord.out,chr5,15946915,15948642,+,2,0,2,known,chr5:15946915-15948642
sample_3_Aligned.sortedByCoord.out,chr19,5756248,5762206,+,8,1,9,known,chr19:5756248-5762206
sample_3_Aligned.sortedByCoord.out,chr14,36572752,36580418,+,8,2,10,known,chr14:36572752-36580418
sample_3_Aligned.sortedByCoord.out,chr3,18317946,18321116,+,9,2,11,novel,chr3:18317946-18321116
sample_3_Aligned.sortedByCoord.out,chr6,35307727,35310671,-,14,2,16,known,chr6:35307727-35310671
sample_3_Aligned.sortedByCoord.out,chr15,46634302,46636333,-,16,3,19,known,chr15:46634302-46636333
sample_3_Aligned.sortedByCoord.out,chr2,18098404,18107035,+,8,1,9,known,chr2:18098404-18107035
sample_3_Aligned.sortedByCoord.out,chr6,6308771,6316460,-,12,3,15,known,chr6:6308771-6316460
sample_3_Aligned.sortedByCoord.out,chr5,35266223,35272324,-,13,2,15,known,chr5:35266223-35272324
sample_3_Aligned.sortedByCoord.out,chr21,17582228,17592086,+,10,1,11,known,chr21:17582228-17592086
sample_3_Aligned.sortedByCoord.out,chr10,18852807,18861645,-,10,0,10,known,chr10:18852807-18861645
sample_3_Aligned.sortedByCoord.out,chr1,47853132,47858785,-,11,4,15,novel,chr1:47853132-47858785
sample_3_Aligned.sortedByCoord.out,chr21,21784796,21793983,+,7,0,7,known,chr21:21784796-21793983
sample_3_Aligned.sortedByCoord.out,chr3,49256854,49259023,+,5,1,6,known,chr3:49256854-49259023
sample_3_Aligned.sortedByCoord.out,chr7,46879554,46884948,-,11,5,16,known,chr7:46879554-46884948
sample_3_Aligned.sortedByCoord.out,chr2,7979612,7987387,+,12,1,13,known,chr2:7979612-7987387
sample_3_Aligned.sortedByCoord.out,chr17,27148471,27157109,+,8,2,10,novel,chr17:27148471-27157109
sample_3_Aligned.sortedByCoord.out,chr4,19199465,19205628,+,8,1,9,known,chr4:19199465-19205628
sample_3_Aligned.sortedByCoord.out,chr13,27650846,27660114,-,17,3,20,known,chr13:27650846-27660114
sample_3_Aligned.sortedByCoord.out,chr2,48370989,48379981,+,9,1,10,known,chr2:48370989-48379981
sample_3_Aligned.sortedByCoord.out,chr12,27535100,27544615,+,11,1,12,novel,chr12:27535100-27544615
sample_3_Aligned.sortedByCoord.out,chr20,28270890,28272790,-,14,2,16,known,chr20:28270890-28272790
sample_3_Aligned.sortedByCoord.out,chr5,47885289,47894975,-,8,2,10,novel,chr5:47885289-47894975
sample_3_Aligned.sortedByCoord.out,chr17,43898079,43903708,+,15,3,18,known,chr17:43898079-43903708
sample_3_Aligned.sortedByCoord.out,chr18,35437360,35445686,+,12,3,15,known,chr18:35437360-35445686
sample_3_Aligned.sortedByCoord.out,chr19,47207056,47215294,+,13,2,15,known,chr19:47207056-47215294
sample_3_Aligned.sortedByCoord.out,chr15,3147450,3157128,+,15,3,18,known,chr15:3147450-3157128
sample_3_Aligned.sortedByCoord.out,chr16,43126916,43127149,+,5,1,6,known,chr16:43126916-43127149
sample_3_Aligned.sortedByCoord.out,chr22,8047996,8050623,+,11,2,13,known,chr22:8047996-8050623
sample_3_Aligned.sortedByCoord.out,chr5,31393507,31396272,+,18,0,18,novel,chr5:31393507-31396272
sample_3_Aligned.sortedByCoord.out,chr5,8778768,8784896,+,14,3,17,known,chr5:8778768-8784896
sample_3_Aligned.sortedByCoord.out,chr2,38462172,38463646,-,12,2,14,known,chr2:38462172-38463646
sample_3_Aligned.sortedByCoord.out,chr2,16337619,16340852,-,10,1,11,novel,chr2:16337619-16340852
sample_3_Aligned.sortedByCoord.out,chr9,20114838,20118078,+,3,5,8,novel,chr9:20114838-20118078
sample_3_Aligned.sortedByCoord.out,chr7,43855268,43862383,+,10,3,13,known,chr7:43855268-43862383
sample_3_Aligned.sortedByCoord.out,chr5,30779422,30789031,-,14,5,19,novel,chr5:30779422-30789031
sample_3_Aligned.sortedByCoord.out,chr5,17106855,17109813,+,12,2,14,known,chr5:17106855-17109813
sample_3_Aligned.sortedByCoord.out,chr14,11962704,11964220,+,9,2,11,known,chr14:11962704-11964220
sample_3_Aligned.sortedByCoord.out,chr10,14940311,14940600,+,12,2,14,novel,chr10:14940311-14940600
sample_3_Aligned.sortedByCoord.out,chr5,41562436,41571378,+,12,0,12,known,chr5:41562436-41571378
sample_3_Aligned.sortedByCoord.out,chr2,15733504,15739497,-,6,4,10,novel,chr2:15733504-15739497
sample_3_Aligned.sortedByCoord.out,chr2,43391954,43399922,+,6,4,10,known,chr2:43391954-43399922
sample_3_Aligned.sortedByCoord.out,chr14,19746071,19754906,-,9,1,10,known,chr14:19746071-19754906
sample_3_Aligned.sortedByCoord.out,chr19,12307872,12314595,-,11,4,15,novel,chr19:12307872-12314595
sample_3_Aligned.sortedByCoord.out,chr7,49797328,49806577,+,15,1,16,known,chr7:49797328-49806577
sample_3_Aligned.sortedByCoord.out,chr1,6282173,6292087,-,10,1,11,known,chr1:6282173-6292087
sample_3_Aligned.sortedByCoord.out,chr17,34606366,34612593,+,9,2,11,known,chr17:34606366-34612593
sample_3_Aligned.sortedByCoord.out,chr7,35990142,35996656,+,12,3,15,known,chr7:35990142-35996656
sample_3_Aligned.sortedByCoord.out,chr12,8844561,8845676,+,6,3,9,novel,chr12:8844561-8845676
sample_3_Aligned.sortedByCoord.out,chr5,19250454,19258751,+,9,2,11,known,chr5:19250454-19258751
sample_3_Aligned.sortedByCoord.out,chr22,13252800,13256360,+,8,1,9,novel,chr22:13252800-13256360
sample_3_Aligned.sortedByCoord.out,chr15,48913295,48918826,+,6,2,8,known,chr15:48913295-48918826
sample_3_Aligned.sortedByCoord.out,chr3,32342108,32347075,-,14,1,15,known,chr3:32342108-32347075
sample_3_Aligned.sortedByCoord.out,chr21,30257957,30264751,-,9,1,10,known,chr21:30257957-30264751
sample_3_Aligned.sortedByCoord.out,chr2,35461393,35467281,-,10,3,13,known,chr2:35461393-35467281
sample_3_Aligned.sortedByCoord.out,chr4,47373173,47380505,-,5,3,8,known,chr4:47373173-47380505
sample_3_Aligned.sortedByCoord.out,chr2,42303534,42311543,+,16,1,17,known,chr2:42303534-42311543
sample_3_Aligned.sortedByCoord.out,chr5,34649011,34655266,+,5,3,8,known,chr5:34649011-34655266
sample_3_Aligned.sortedByCoord.out,chr6,18503537,18511761,-,5,0,5,known,chr6:18503537-18511761
sample_3_Aligned.sortedByCoord.out,chr6,18702697,18710913,-,15,4,19,known,chr6:18702697-18710913
sample_3_Aligned.sortedByCoord.out,chr5,24413399,24416385,-,11,0,11,known,chr5:24413399-24416385
sample_3_Aligned.sortedByCoord.out,chr2,6173743,6183456,+,9,3,12,known,chr2:6173743-6183456
sample_3_Aligned.sortedByCoord.out,chr9,2540782,2541614,+,11,2,13,known,chr9:2540782-2541614
sample_3_Aligned.sortedByCoord.out,chr3,16866172,16871630,+,12,1,13,known,chr3:16866172-16871630
sample_3_Aligned.sortedByCoord.out,chr5,20795391,20802876,+,11,2,13,known,chr5:20795391-20802876
sample_3_Aligned.sortedByCoord.out,chr13,9370001,9376773,-,12,0,12,novel,chr13:9370001-9376773
sample_3_Aligned.sortedByCoord.out,chr2,42991054,42995009,+,10,4,14,known,chr2:42991054-42995009
sample_3_Aligned.sortedByCoord.out,chr14,45392052,45393899,-,7,1,8,known,chr14:45392052-45393899
sample_3_Aligned.sortedByCoord.out,chr22,39562240,39563940,+,10,3,13,known,chr22:39562240-39563940
sample_3_Aligned.sortedByCoord.out,chr8,18816838,18820465,+,5,2,7,known,chr8:18816838-18820465
sample_3_Aligned.sortedByCoord.out,chr2,34673112,34678420,+,9,0,9,known,chr2:34673112-34678420
sample_3_Aligned.sortedByCoord.out,chr15,39984202,39987931,-,10,2,12,known,chr15:39984202-39987931
sample_3_Aligned.sortedByCoord.out,chr4,35703671,35712927,-,11,2,13,known,chr4:35703671-35712927
sample_3_Aligned.sortedByCoord.out,chr5,13654535,13660515,+,8,4,12,known,chr5:13654535-13660515
sample_3_Aligned.sortedByCoord.out,chr6,11624052,11624188,-,6,3,9,known,chr6:11624052-11624188
sample_3_Aligned.sortedByCoord.out,chr22,18489226,18489829,+,6,1,7,known,chr22:18489226-18489829
sample_3_Aligned.sortedByCoord.out,chr8,2781004,2783615,+,10,3,13,known,chr8:2781004-2783615
sample_3_Aligned.sortedByCoord.out,chr6,38339844,38344866,-,6,2,8,known,chr6:38339844-38344866
sample_3_Aligned.sortedByCoord.out,chr2,33160413,33162996,+,13,4,17,known,chr2:33160413-33162996
sample_3_Aligned.sortedByCoord.out,chr19,36322741,36327211,+,12,5,17,known,chr19:36322741-36327211
sample_3_Aligned.sortedByCoord.out,chr16,37499459,37503059,+,10,2,12,known,chr16:37499459-37503059
sample_3_Aligned.sortedByCoord.out,chr20,41612362,41615664,-,8,2,10,known,chr20:41612362-41615664
sample_3_Aligned.sortedByCoord.out,chr2,14155799,14165759,+,12,3,15,known,chr2:14155799-14165759
sample_3_Aligned.sortedByCoord.out,chr13,15140056,15145261,-,8,3,11,novel,chr13:15140056-15145261
sample_3_Aligned.sortedByCoord.out,chr9,41314836,41321219,-,12,1,13,known,chr9:41314836-41321219
sample_3_Aligned.sortedByCoord.out,chr13,23758223,23761000,-,7,3,10,known,chr13:23758223-23761000
sample_3_Aligned.sortedByCoord.out,chr1,20342424,20349486,+,7,3,10,known,chr1:20342424-20349486
sample_3_Aligned.sortedByCoord.out,chr15,48336270,48339601,+,9,3,12,novel,chr15:48336270-48339601
sample_3_Aligned.sortedByCoord.out,chr9,28642999,28647844,-,13,1,14,known,chr9:28642999-28647844
sample_3_Aligned.sortedByCoord.out,chr4,13905824,13911618,+,11,5,16,known,chr4:13905824-13911618
sample_3_Aligned.sortedByCoord.out,chr11,35708563,35714902,-,6,5,11,known,chr11:35708563-35714902
sample_3_Aligned.sortedByCoord.out,chr8,17282879,17285868,+,12,1,13,known,chr8:17282879-17285868
sample_3_Aligned.sortedByCoord.out,chr16,25466918,25471365,+,7,1,8,known,chr16:25466918-25471365
sample_3_Aligned.sortedByCoord.out,chr5,13699492,13707351,-,13,0,13,known,chr5:13699492-13707351
sample_3_Aligned.sortedByCoord.out,chr7,14684079,14685289,+,13,1,14,novel,chr7:14684079-14685289
sample_3_Aligned.sortedByCoord.out,chr16,43887175,43895046,-,7,1,8,known,chr16:43887175-43895046
sample_3_Aligned.sortedByCoord.out,chr6,19458742,19465270,-,9,2,11,known,chr6:19458742-19465270
sample_3_Aligned.sortedByCoord.out,chr19,30696146,30700769,-,7,6,13,known,chr19:30696146-30700769
sample_3_Aligned.sortedByCoord.out,chr10,17804996,17811060,+,10,2,12,known,chr10:17804996-17811060
sample_3_Aligned.sortedByCoord.out,chr5,27656397,27664682,+,8,2,10,known,chr5:27656397-27664682
sample_3_Aligned.sortedByCoord.out,chr5,47768255,47774137,-,9,0,9,known,chr5:47768255-47774137
sample_3_Aligned.sortedByCoord.out,chr11,26241027,26245632,-,13,1,14,known,chr11:26241027-26245632
sample_3_Aligned.sortedByCoord.out,chr5,17164675,17165911,-,7,1,8,known,chr5:17164675-17165911
sample_3_Aligned.sortedByCoord.out,chr7,43048040,43055102,+,11,0,11,known,chr7:43048040-43055102
sample_3_Aligned.sortedByCoord.out,chr18,24316368,24323169,-,20,3,23,known,chr18:24316368-24323169
sample_3_Aligned.sortedByCoord.out,chr15,14945553,14954638,-,14,2,16,known,chr15:14945553-14954638
sample_3_Aligned.sortedByCoord.out,chr20,24062465,24065243,-,11,3,14,known,chr20:24062465-24065243
sample_3_Aligned.sortedByCoord.out,chr5,44490315,44494072,+,17,0,17,known,chr5:44490315-44494072
sample_3_Aligned.sortedByCoord.out,chr3,18033835,18040826,+,3,2,5,novel,chr3:18033835-18040826
sample_3_Aligned.sortedByCoord.out,chr17,48253073,48254656,+,15,3,18,known,chr17:48253073-48254656
sample_3_Aligned.sortedByCoord.out,chr8,5857995,5863401,+,13,2,15,novel,chr8:5857995-5863401
sample_3_Aligned.sortedByCoord.out,chr21,14277484,14283684,+,12,0,12,known,chr21:14277484-14283684
sample_3_Aligned.sortedByCoord.out,chr9,16367192,16374082,-,10,0,10,known,chr9:16367192-16374082
sample_3_Aligned.sortedByCoord.out,chr21,33342642,33351764,-,12,1,13,novel,chr21:33342642-33351764
sample_3_Aligned.sortedByCoord.out,chr18,5808684,5811642,+,4,2,6,known,chr18:5808684-5811642
sample_3_Aligned.sortedByCoord.out,chr22,33664425,33672543,-,11,1,12,known,chr22:33664425-33672543
sample_3_Aligned.sortedByCoord.out,chr4,29458020,29460001,+,7,1,8,known,chr4:29458020-29460001
sample_3_Aligned.sortedByCoord.out,chr20,33363801,33371743,-,8,3,11,known,chr20:33363801-33371743
sample_3_Aligned.sortedByCoord.out,chr12,33350985,33353902,+,2,2,4,known,chr12:33350985-33353902
sample_3_Aligned.sortedByCoord.out,chr7,42726740,42735989,+,14,2,16,novel,chr7:42726740-42735989
sample_3_Aligned.sortedByCoord.out,chr11,44677705,44679832,+,10,2,12,novel,chr11:44677705-44679832
sample_3_Aligned.sortedByCoord.out,chr22,47296655,47306477,-,10,3,13,known,chr22:47296655-47306477
sample_3_Aligned.sortedByCoord.out,chr4,49447014,49450576,-,17,2,19,known,chr4:49447014-49450576
sample_3_Aligned.sortedByCoord.out,chr1,12881029,12888204,-,12,2,14,known,chr1:12881029-12888204
sample_3_Aligned.sortedByCoord.out,chr14,33281307,33288477,-,12,2,14,known,chr14:33281307-33288477
sample_3_Aligned.sortedByCoord.out,chr1,26976875,26982255,-,14,1,15,novel,chr1:26976875-26982255
sample_3_Aligned.sortedByCoord.out,chr21,5384739,5394009,-,10,2,12,known,chr21:5384739-5394009
sample_3_Aligned.sortedByCoord.out,chr7,2098418,2103371,+,8,3,11,known,chr7:2098418-2103371
sample_3_Aligned.sortedByCoord.out,chr5,22941072,22948559,-,7,5,12,known,chr5:22941072-22948559
sample_3_Aligned.sortedByCoord.out,chr16,10114580,10116383,-,9,0,9,known,chr16:10114580-10116383
sample_3_Aligned.sortedByCoord.out,chr5,39634922,39636374,-,13,0,13,known,chr5:39634922-39636374
sample_3_Aligned.sortedByCoord.out,chr15,31793920,31797125,+,17,5,22,known,chr15:31793920-31797125
sample_3_Aligned.sortedByCoord.out,chr2,27309343,27316151,+,6,1,7,known,chr2:27309343-27316151
sample_3_Aligned.sortedByCoord.out,chr7,19054963,19056522,+,15,1,16,known,chr7:19054963-19056522
sample_3_Aligned.sortedByCoord.out,chr13,42605646,42615341,+,17,1,18,novel,chr13:42605646-42615341
sample_3_Aligned.sortedByCoord.out,chr5,8331096,8335690,-,13,2,15,known,chr5:8331096-8335690
sample_3_Aligned.sortedByCoord.out,chr7,17459723,17467561,+,12,1,13,known,chr7:17459723-17467561
sample_3_Aligned.sortedByCoord.out,chr19,36233542,36242554,+,11,0,11,known,chr19:36233542-36242554
sample_3_Aligned.sortedByCoord.out,chr2,38977921,38984431,-,12,1,13,known,chr2:38977921-38984431
sample_3_Aligned.sortedByCoord.out,chr13,41153099,41153930,-,12,0,12,known,chr13:41153099-41153930
sample_3_Aligned.sortedByCoord.out,chr20,24240034,24240267,-,10,6,16,known,chr20:24240034-24240267
sample_3_Aligned.sortedByCoord.out,chr11,1629450,1637912,-,12,2,14,known,chr11:1629450-1637912
sample_3_Aligned.sortedByCoord.out,chr19,14243158,14244651,-,8,1,9,known,chr19:14243158-14244651
sample_3_Aligned.sortedByCoord.out,chr9,27518971,27520499,-,7,0,7,known,chr9:27518971-27520499
sample_3_Aligned.sortedByCoord.out,chr12,37990010,37993643,-,8,2,10,novel,chr12:37990010-37993643
sample_3_Aligned.sortedByCoord.out,chr13,13953041,13960898,+,18,2,20,known,chr13:13953041-13960898
sample_3_Aligned.sortedByCoord.out,chr4,25849983,25852799,+,7,1,8,known,chr4:25849983-25852799
sample_3_Aligned.sortedByCoord.out,chr12,48830805,48835446,-,8,1,9,known,chr12:48830805-48835446
sample_3_Aligned.sortedByCoord.out,chr11,11010993,11017078,+,16,1,17,known,chr11:11010993-11017078
sample_3_Aligned.sortedByCoord.out,chr15,4362955,4371946,+,6,0,6,known,chr15:4362955-4371946
sample_3_Aligned.sortedByCoord.out,chr14,35147689,35150528,+,9,0,9,known,chr14:35147689-35150528
sample_3_Aligned.sortedByCoord.out,chr21,26412237,26415711,+,10,1,11,known,chr21:26412237-26415711
sample_3_Aligned.sortedByCoord.out,chr22,45994394,45996294,-,10,2,12,known,chr22:45994394-45996294
sample_3_Aligned.sortedByCoord.out,chr1,46823279,46827496,-,13,3,16,known,chr1:46823279-46827496
sample_3_Aligned.sortedByCoord.out,chr22,33892371,33897122,+,14,2,16,known,chr22:33892371-33897122
sample_3_Aligned.sortedByCoord.out,chr15,42084395,42093220,-,10,0,10,known,chr15:42084395-42093220
sample_3_Aligned.sortedByCoord.out,chr13,38906436,38909300,+,12,1,13,known,chr13:38906436-38909300
sample_3_Aligned.sortedByCoord.out,chr2,35634806,35640976,-,13,0,13,known,chr2:35634806-35640976
sample_3_Aligned.sortedByCoord.out,chr9,21239622,21243804,-,14,3,17,known,chr9:21239622-21243804
sample_3_Aligned.sortedByCoord.out,chr17,8604831,8606141,+,16,0,16,novel,chr17:8604831-8606141
sample_3_Aligned.sortedByCoord.out,chr11,24994954,24997963,-,15,3,18,known,chr11:24994954-24997963
sample_3_Aligned.sortedByCoord.out,chr6,41836638,41840702,-,6,1,7,known,chr6:41836638-41840702
sample_3_Aligned.sortedByCoord.out,chr21,11531482,11537226,-,15,2,17,known,chr21:11531482-11537226
sample_3_Aligned.sortedByCoord.out,chr17,20668562,20676658,+,4,5,9,known,chr17:20668562-20676658
sample_3_Aligned.sortedByCoord.out,chr2,12049641,12049865,-,11,2,13,known,chr2:12049641-12049865
sample_3_Aligned.sortedByCoord.out,chr7,12774704,12779064,+,14,3,17,known,chr7:12774704-12779064
sample_3_Aligned.sortedByCoord.out,chr7,44152330,44159714,-,8,1,9,known,chr7:44152330-44159714
sample_3_Aligned.sortedByCoord.out,chr7,5974310,5981771,+,12,0,12,known,chr7:5974310-5981771
sample_3_Aligned.sortedByCoord.out,chr9,2166566,2174891,-,13,2,15,known,chr9:2166566-2174891
sample_3_Aligned.sortedByCoord.out,chr12,15000304,15009230,+,10,4,14,known,chr12:15000304-15009230
sample_3_Aligned.sortedByCoord.out,chr21,38145430,38150734,+,7,0,7,known,chr21:38145430-38150734
sample_3_Aligned.sortedByCoord.out,chr2,32829793,32834211,+,11,0,11,known,chr2:32829793-32834211
sample_3_Aligned.sortedByCoord.out,chr18,35458892,35466700,+,6,4,10,known,chr18:35458892-35466700
sample_3_Aligned.sortedByCoord.out,chr12,19446393,19448513,-,5,1,6,known,chr12:19446393-19448513
sample_3_Aligned.sortedByCoord.out,chr16,42266561,42276123,-,6,4,10,known,chr16:42266561-42276123
sample_3_Aligned.sortedByCoord.out,chr3,41659210,41660700,-,7,3,10,known,chr3:41659210-41660700
sample_3_Aligned.sortedByCoord.out,chr18,44408331,44408629,-,11,3,14,known,chr18:44408331-44408629
sample_3_Aligned.sortedByCoord.out,chr12,43433753,43434754,-,9,2,11,novel,chr12:43433753-43434754
sample_3_Aligned.sortedByCoord.out,chr14,20898434,20903257,+,9,2,11,known,chr14:20898434-20903257
sample_3_Aligned.sortedByCoord.out,chr18,45318148,45327289,+,5,4,9,known,chr18:45318148-45327289
sample_3_Aligned.sortedByCoord.out,chr4,28302946,28303354,+,9,2,11,novel,chr4:28302946-28303354
sample_3_Aligned.sortedByCoord.out,chr3,16383953,16392973,+,13,1,14,known,chr3:16383953-16392973
sample_3_Aligned.sortedByCoord.out,chr7,25088661,25094208,+,8,1,9,novel,chr7:25088661-25094208
sample_3_Aligned.sortedByCoord.out,chr15,10827953,10832111,-,10,0,10,known,chr15:10827953-10832111
sample_3_Aligned.sortedByCoord.out,chr8,31116826,31119954,+,10,4,14,known,chr8:31116826-31119954
sample_3_Aligned.sortedByCoord.out,chr7,3984064,3989457,-,11,4,15,known,chr7:3984064-3989457
sample_3_Aligned.sortedByCoord.out,chr21,22417946,22423282,-,7,4,11,known,chr21:22417946-22423282
sample_3_Aligned.sortedByCoord.out,chr4,6131924,6141145,+,11,2,13,known,chr4:6131924-6141145
sample_3_Aligned.sortedByCoord.out,chr8,29537108,29543783,+,7,1,8,known,chr8:29537108-29543783
sample_3_Aligned.sortedByCoord.out,chr15,18721928,18726802,-,8,1,9,novel,chr15:18721928-18726802
sample_3_Aligned.sortedByCoord.out,chr17,12103297,12108389,-,8,0,8,novel,chr17:12103297-12108389
sample_3_Aligned.sortedByCoord.out,chr9,45536403,45542879,+,8,2,10,known,chr9:45536403-45542879
sample_3_Aligned.sortedByCoord.out,chr11,18796950,18805550,+,17,2,19,known,chr11:18796950-18805550
sample_3_Aligned.sortedByCoord.out,chr2,39547509,39548185,-,12,1,13,known,chr2:39547509-39548185
sample_3_Aligned.sortedByCoord.out,chr21,15711108,15719404,-,9,5,14,novel,chr21:15711108-15719404
sample_3_Aligned.sortedByCoord.out,chr18,13984849,13992151,-,17,0,17,known,chr18:13984849-13992151
sample_3_Aligned.sortedByCoord.out,chr12,37587317,37590892,-,11,0,11,known,chr12:37587317-37590892
sample_3_Aligned.sortedByCoord.out,chr16,16863406,16866744,+,10,3,13,known,chr16:16863406-16866744
sample_3_Aligned.sortedByCoord.out,chr12,2206092,2206355,+,10,2,12,known,chr12:2206092-2206355
sample_3_Aligned.sortedByCoord.out,chr21,19766670,19769498,-,7,4,11,known,chr21:19766670-19769498
sample_3_Aligned.sortedByCoord.out,chr11,7200906,7207016,-,12,2,14,known,chr11:7200906-7207016
sample_3_Aligned.sortedByCoord.out,chr5,24193113,24199407,+,10,1,11,known,chr5:24193113-24199407
sample_3_Aligned.sortedByCoord.out,chr18,41881013,41883176,-,10,3,13,known,chr18:41881013-41883176
sample_3_Aligned.sortedByCoord.out,chr2,23101766,23102239,-,8,1,9,novel,chr2:23101766-23102239
sample_3_Aligned.sortedByCoord.out,chr13,25253513,25263087,-,11,3,14,novel,chr13:25253513-25263087
sample_3_Aligned.sortedByCoord.out,chr21,29193250,29193585,-,12,3,15,known,chr21:29193250-29193585
sample_3_Aligned.sortedByCoord.out,chr6,30141161,30141267,-,8,0,8,known,chr6:30141161-30141267
sample_3_Aligned.sortedByCoord.out,chr20,16246391,16250329,-,11,1,12,novel,chr20:16246391-16250329
sample_3_Aligned.sortedByCoord.out,chr5,20301726,20309423,-,14,6,20,known,chr5:20301726-20309423
sample_3_Aligned.sortedByCoord.out,chr1,2192675,2201004,-,14,4,18,novel,chr1:2192675-2201004
sample_3_Aligned.sortedByCoord.out,chr10,3309176,3318392,-,10,4,14,known,chr10:3309176-3318392
sample_3_Aligned.sortedByCoord.out,chr8,2288870,2294009,+,11,1,12,novel,chr8:2288870-2294009
sample_3_Aligned.sortedByCoord.out,chr5,22882789,22890608,+,9,0,9,known,chr5:22882789-22890608
sample_3_Aligned.sortedByCoord.out,chr21,18541152,18547924,-,10,2,12,known,chr21:18541152-18547924
sample_3_Aligned.sortedByCoord.out,chr15,26727662,26737229,+,10,2,12,novel,chr15:26727662-26737229
sample_3_Aligned.sortedByCoord.out,chr20,28863456,28868905,-,9,6,15,known,chr20:28863456-28868905
sample_3_Aligned.sortedByCoord.out,chr11,47307211,47309222,-,8,1,9,known,chr11:47307211-47309222
sample_3_Aligned.sortedByCoord.out,chr12,25847802,25852625,-,7,7,14,known,chr12:25847802-25852625
sample_3_Aligned.sortedByCoord.out,chr16,35884582,35886145,-,8,2,10,novel,chr16:35884582-35886145
sample_3_Aligned.sortedByCoord.out,chr14,39816021,39817917,-,16,2,18,known,chr14:39816021-39817917
sample_3_Aligned.sortedByCoord.out,chr7,12715373,12723220,-,9,5,14,known,chr7:12715373-12723220
sample_3_Aligned.sortedByCoord.out,chr14,9520258,9526731,+,8,1,9,known,chr14:9520258-9526731
sample_3_Aligned.sortedByCoord.out,chr22,23282450,23291322,-,17,0,17,known,chr22:23282450-23291322
sample_3_Aligned.sortedByCoord.out,chr16,32987323,32994089,+,12,3,15,known,chr16:32987323-32994089
sample_3_Aligned.sortedByCoord.out,chr21,9008426,9015927,-,5,2,7,known,chr21:9008426-9015927
sample_3_Aligned.sortedByCoord.out,chr17,41471879,41477459,-,15,0,15,novel,chr17:41471879-41477459
sample_3_Aligned.sortedByCoord.out,chr19,22096716,22103129,+,10,2,12,novel,chr19:22096716-22103129
sample_3_Aligned.sortedByCoord.out,chr20,40048378,40051065,-,7,2,9,known,chr20:40048378-40051065
sample_3_Aligned.sortedByCoord.out,chr18,12494897,12501123,+,9,0,9,known,chr18:12494897-12501123
sample_3_Aligned.sortedByCoord.out,chr11,2142951,2145094,+,9,1,10,known,chr11:2142951-2145094
sample_3_Aligned.sortedByCoord.out,chr2,42972487,42981333,-,12,1,13,known,chr2:42972487-42981333
sample_3_Aligned.sortedByCoord.out,chr5,33682130,33685920,+,9,3,12,known,chr5:33682130-33685920
sample_3_Aligned.sortedByCoord.out,chr6,17686848,17695140,+,10,2,12,known,chr6:17686848-17695140
sample_3_Aligned.sortedByCoord.out,chr7,34045387,34054193,-,18,1,19,known,chr7:34045387-34054193
sample_3_Aligned.sortedByCoord.out,chr17,44544584,44546730,+,11,2,13,known,chr17:44544584-44546730
sample_3_Aligned.sortedByCoord.out,chr15,7124433,7132684,+,8,3,11,known,chr15:7124433-7132684
sample_3_Aligned.sortedByCoord.out,chr15,6454237,6454726,+,14,1,15,known,chr15:6454237-6454726
sample_3_Aligned.sortedByCoord.out,chr5,7654574,7656815,+,12,2,14,known,chr5:7654574-7656815
sample_3_Aligned.sortedByCoord.out,chr4,24342584,24350937,-,8,0,8,novel,chr4:24342584-24350937
sample_3_Aligned.sortedByCoord.out,chr22,23093470,23094612,+,10,1,11,known,chr22:23093470-23094612
sample_3_Aligned.sortedByCoord.out,chr19,47347782,47350438,-,12,1,13,known,chr19:47347782-47350438
sample_3_Aligned.sortedByCoord.out,chr16,36680339,36680720,+,9,2,11,known,chr16:36680339-36680720
sample_3_Aligned.sortedByCoord.out,chr7,47756285,47758462,-,9,3,12,known,chr7:47756285-47758462
sample_3_Aligned.sortedByCoord.out,chr22,22684904,22685261,+,12,4,16,novel,chr22:22684904-22685261
sample_3_Aligned.sortedByCoord.out,chr4,32873345,32876829,+,11,6,17,known,chr4:32873345-32876829
sample_3_Aligned.sortedByCoord.out,chr11,8861276,8866091,-,12,3,15,known,chr11:8861276-8866091
sample_3_Aligned.sortedByCoord.out,chr15,19459424,19466446,+,7,2,9,known,chr15:19459424-19466446
sample_3_Aligned.sortedByCoord.out,chr13,4887252,4889666,+,11,3,14,known,chr13:4887252-4889666
sample_3_Aligned.sortedByCoord.out,chr1,37861976,37864916,+,6,0,6,novel,chr1:37861976-37864916
sample_3_Aligned.sortedByCoord.out,chr17,28491886,28496922,-,12,4,16,known,chr17:28491886-28496922
sample_3_Aligned.sortedByCoord.out,chr20,21957267,21959888,+,5,2,7,known,chr20:21957267-21959888
sample_3_Aligned.sortedByCoord.out,chr3,28724058,28728249,-,8,1,9,known,chr3:28724058-28728249
sample_3_Aligned.sortedByCoord.out,chr19,38569583,38576719,+,9,2,11,known,chr19:38569583-38576719
sample_3_Aligned.sortedByCoord.out,chr13,23949720,23951662,+,4,1,5,known,chr13:23949720-23951662
sample_3_Aligned.sortedByCoord.out,chr12,28111723,28119693,+,13,1,14,known,chr12:28111723-28119693
sample_3_Aligned.sortedByCoord.out,chr6,11827944,11837290,-,8,1,9,novel,chr6:11827944-11837290
sample_3_Aligned.sortedByCoord.out,chr3,16052551,16059524,-,8,3,11,known,chr3:16052551-16059524
sample_3_Aligned.sortedByCoord.out,chr7,44641934,44650570,-,11,1,12,known,chr7:44641934-44650570
sample_3_Aligned.sortedByCoord.out,chr1,43026453,43034343,-,2,0,2,novel,chr1:43026453-43034343
sample_3_Aligned.sortedByCoord.out,chr12,7329165,7329839,+,8,0,8,known,chr12:7329165-7329839
sample_3_Aligned.sortedByCoord.out,chr19,33314819,33321534,-,12,1,13,known,chr19:33314819-33321534
sample_3_Aligned.sortedByCoord.out,chr3,7658304,7660823,+,6,1,7,known,chr3:7658304-7660823
sample_3_Aligned.sortedByCoord.out,chr6,20457683,20464278,+,13,5,18,known,chr6:20457683-20464278
sample_3_Aligned.sortedByCoord.out,chr9,41846235,41850374,-,8,2,10,known,chr9:41846235-41850374
sample_3_Aligned.sortedByCoord.out,chr16,16311471,16316949,+,11,3,14,known,chr16:16311471-16316949
sample_3_Aligned.sortedByCoord.out,chr10,47808031,47816351,-,6,2,8,known,chr10:47808031-47816351
sample_3_Aligned.sortedByCoord.out,chr14,5500619,5504272,+,11,3,14,known,chr14:5500619-5504272
sample_3_Aligned.sortedByCoord.out,chr15,4834837,4835398,-,6,2,8,known,chr15:4834837-4835398
sample_3_Aligned.sortedByCoord.out,chr7,32131455,32132573,+,17,2,19,novel,chr7:32131455-32132573
sample_3_Aligned.sortedByCoord.out,chr10,16583063,16592614,-,8,2,10,known,chr10:16583063-16592614
sample_3_Aligned.sortedByCoord.out,chr8,13840205,13843024,-,8,5,13,known,chr8:13840205-13843024
sample_3_Aligned.sortedByCoord.out,chr8,45560002,45568828,-,9,1,10,known,chr8:45560002-45568828
sample_3_Aligned.sortedByCoord.out,chr9,2232393,2232849,+,8,1,9,known,chr9:2232393-2232849
sample_3_Aligned.sortedByCoord.out,chr8,44894148,44904055,-,14,4,18,novel,chr8:44894148-44904055
sample_3_Aligned.sortedByCoord.out,chr22,48421086,48422663,+,9,2,11,known,chr22:48421086-48422663
sample_3_Aligned.sortedByCoord.out,chr15,9432596,9439068,+,15,2,17,known,chr15:9432596-9439068
sample_3_Aligned.sortedByCoord.out,chr2,32819164,32824424,-,8,2,10,known,chr2:32819164-32824424
sample_3_Aligned.sortedByCoord.out,chr10,36193193,36195676,+,6,0,6,known,chr10:36193193-36195676
sample_3_Aligned.sortedByCoord.out,chr17,2366203,2375882,-,7,4,11,novel,chr17:2366203-2375882
sample_3_Aligned.sortedByCoord.out,chr13,24132971,24142830,-,6,1,7,known,chr13:24132971-24142830
sample_3_Aligned.sortedByCoord.out,chr17,6136082,6136683,+,9,2,11,known,chr17:6136082-6136683
sample_3_Aligned.sortedByCoord.out,chr14,49820773,49825781,-,7,0,7,known,chr14:49820773-49825781
sample_3_Aligned.sortedByCoord.out,chr21,25680958,25687056,+,11,6,17,known,chr21:25680958-25687056
sample_3_Aligned.sortedByCoord.out,chr10,1733639,1742369,-,12,2,14,known,chr10:1733639-1742369
sample_3_Aligned.sortedByCoord.out,chr6,32743757,32748837,-,9,4,13,known,chr6:32743757-32748837
sample_3_Aligned.sortedByCoord.out,chr1,41409528,41411737,-,10,1,11,known,chr1:41409528-41411737
sample_3_Aligned.sortedByCoord.out,chr17,42227845,42231018,+,25,2,27,known,chr17:42227845-42231018
sample_3_Aligned.sortedByCoord.out,chr12,36672617,36676936,-,11,1,12,known,chr12:36672617-36676936
sample_3_Aligned.sortedByCoord.out,chr15,7356026,7360279,-,8,2,10,known,chr15:7356026-7360279
sample_3_Aligned.sortedByCoord.out,chr7,36482743,36487229,-,7,2,9,known,chr7:36482743-36487229
sample_3_Aligned.sortedByCoord.out,chr17,39778871,39779770,+,10,6,16,known,chr17:39778871-39779770
sample_3_Aligned.sortedByCoord.out,chr11,25270960,25274225,-,8,2,10,novel,chr11:25270960-25274225
sample_3_Aligned.sortedByCoord.out,chr12,6506482,6507711,-,9,4,13,known,chr12:6506482-6507711
sample_3_Aligned.sortedByCoord.out,chr6,22743995,22750473,+,9,2,11,known,chr6:22743995-22750473
sample_3_Aligned.sortedByCoord.out,chr10,14590956,14600375,-,13,3,16,known,chr10:14590956-14600375
sample_3_Aligned.sortedByCoord.out,chr2,2472616,2477270,+,13,2,15,known,chr2:2472616-2477270
sample_3_Aligned.sortedByCoord.out,chr6,8142694,8152597,+,10,3,13,known,chr6:8142694-8152597
sample_3_Aligned.sortedByCoord.out,chr1,14163133,14166134,-,14,3,17,known,chr1:14163133-14166134
sample_3_Aligned.sortedByCoord.out,chr4,41554525,41558717,-,12,2,14,novel,chr4:41554525-41558717
sample_3_Aligned.sortedByCoord.out,chr2,42174306,42180083,+,8,2,10,known,chr2:42174306-42180083
sample_3_Aligned.sortedByCoord.out,chr1,18880248,18884955,-,7,3,10,known,chr1:18880248-18884955
sample_3_Aligned.sortedByCoord.out,chr13,41078755,41085017,+,5,3,8,novel,chr13:41078755-41085017
sample_3_Aligned.sortedByCoord.out,chr3,27265747,27275354,+,14,3,17,known,chr3:27265747-27275354
sample_3_Aligned.sortedByCoord.out,chr12,44528412,44535274,+,8,4,12,known,chr12:44528412-44535274
sample_3_Aligned.sortedByCoord.out,chr9,3657289,3661280,+,10,1,11,known,chr9:3657289-3661280
sample_3_Aligned.sortedByCoord.out,chr12,20665948,20668723,-,7,2,9,known,chr12:20665948-20668723
sample_3_Aligned.sortedByCoord.out,chr19,47009724,47016620,-,14,1,15,novel,chr19:47009724-47016620
sample_3_Aligned.sortedByCoord.out,chr20,3030157,3038135,-,5,2,7,known,chr20:3030157-3038135
sample_3_Aligned.sortedByCoord.out,chr19,2664592,2668986,+,10,1,11,known,chr19:2664592-2668986
sample_3_Aligned.sortedByCoord.out,chr15,34535094,34535454,-,5,2,7,novel,chr15:34535094-34535454
sample_3_Aligned.sortedByCoord.out,chr8,25775256,25780435,+,11,2,13,novel,chr8:25775256-25780435
sample_3_Aligned.sortedByCoord.out,chr11,13925884,13926695,+,13,4,17,known,chr11:13925884-13926695
sample_3_Aligned.sortedByCoord.out,chr6,39818559,39820867,+,7,2,9,novel,chr6:39818559-39820867
sample_3_Aligned.sortedByCoord.out,chr4,11055665,11058815,+,13,3,16,known,chr4:11055665-11058815
sample_3_Aligned.sortedByCoord.out,chr19,32533557,32534034,+,10,0,10,known,chr19:32533557-32534034
sample_3_Aligned.sortedByCoord.out,chr5,11125245,11134295,+,15,2,17,known,chr5:11125245-11134295
sample_3_Aligned.sortedByCoord.out,chr8,36219741,36220320,-,7,2,9,known,chr8:36219741-36220320
sample_3_Aligned.sortedByCoord.out,chr4,32098611,32099349,-,9,1,10,known,chr4:32098611-32099349
sample_3_Aligned.sortedByCoord.out,chr1,25080488,25085606,+,7,1,8,novel,chr1:25080488-25085606
sample_3_Aligned.sortedByCoord.out,chr5,6924215,6926300,+,9,0,9,known,chr5:6924215-6926300
sample_3_Aligned.sortedByCoord.out,chr8,7897261,7901608,+,14,1,15,known,chr8:7897261-7901608
sample_3_Aligned.sortedByCoord.out,chr4,20646865,20649657,-,6,0,6,novel,chr4:20646865-20649657
sample_3_Aligned.sortedByCoord.out,chr17,39015314,39020066,-,4,3,7,known,chr17:39015314-39020066
sample_3_Aligned.sortedByCoord.out,chr21,2067508,2073692,-,8,0,8,novel,chr21:2067508-2073692
sample_3_Aligned.sortedByCoord.out,chr8,36374080,36374771,-,13,1,14,known,chr8:36374080-36374771
sample_3_Aligned.sortedByCoord.out,chr21,45452918,45453929,-,11,2,13,known,chr21:45452918-45453929
sample_3_Aligned.sortedByCoord.out,chr9,1324220,1325449,+,7,2,9,known,chr9:1324220-1325449
sample_3_Aligned.sortedByCoord.out,chr10,37621656,37625361,-,10,2,12,novel,chr10:37621656-37625361
sample_3_Aligned.sortedByCoord.out,chr13,1005531,1015365,-,6,1,7,known,chr13:1005531-1015365
sample_3_Aligned.sortedByCoord.out,chr22,4246772,4256655,+,11,3,14,known,chr22:4246772-4256655
sample_3_Aligned.sortedByCoord.out,chr9,41600736,41609712,+,10,1,11,known,chr9:41600736-41609712
sample_3_Aligned.sortedByCoord.out,chr11,20060661,20069063,+,10,5,15,known,chr11:20060661-20069063
sample_3_Aligned.sortedByCoord.out,chr9,38734278,38740011,+,10,1,11,known,chr9:38734278-38740011
sample_3_Aligned.sortedByCoord.out,chr14,43011593,43020408,+,8,4,12,known,chr14:43011593-43020408
sample_3_Aligned.sortedByCoord.out,chr1,13974785,13983091,-,16,4,20,novel,chr1:13974785-13983091
sample_3_Aligned.sortedByCoord.out,chr13,9373383,9383301,-,10,3,13,known,chr13:9373383-9383301
sample_3_Aligned.sortedByCoord.out,chr14,13273041,13277821,-,8,2,10,known,chr14:13273041-13277821
sample_3_Aligned.sortedByCoord.out,chr12,37047079,37054619,-,6,2,8,known,chr12:37047079-37054619
sample_3_Aligned.sortedByCoord.out,chr10,28251066,28254663,+,6,3,9,known,chr10:28251066-28254663
sample_3_Aligned.sortedByCoord.out,chr1,11401801,11407468,+,7,1,8,known,chr1:11401801-11407468
sample_3_Aligned.sortedByCoord.out,chr11,13985004,13987562,-,10,1,11,known,chr11:13985004-13987562
sample_3_Aligned.sortedByCoord.out,chr13,41356799,41364375,+,10,3,13,known,chr13:41356799-41364375
sample_3_Aligned.sortedByCoord.out,chr7,46879001,46884270,+,10,0,10,novel,chr7:46879001-46884270
sample_3_Aligned.sortedByCoord.out,chr9,11529082,11537199,-,9,0,9,known,chr9:11529082-11537199
sample_3_Aligned.sortedByCoord.out,chr7,24322710,24323598,+,13,1,14,known,chr7:24322710-24323598
sample_3_Aligned.sortedByCoord.out,chr15,40886719,40887036,+,8,3,11,known,chr15:40886719-40887036
sample_3_Aligned.sortedByCoord.out,chr9,4579897,4584042,-,9,3,12,known,chr9:4579897-4584042
sample_3_Aligned.sortedByCoord.out,chr19,7535303,7535888,-,10,1,11,known,chr19:7535303-7535888
sample_3_Aligned.sortedByCoord.out,chr12,14111311,14113917,+,13,5,18,novel,chr12:14111311-14113917
sample_3_Aligned.sortedByCoord.out,chr9,27453731,27456938,+,11,1,12,known,chr9:27453731-27456938
sample_3_Aligned.sortedByCoord.out,chr8,8391766,8400340,+,10,2,12,known,chr8:8391766-8400340
sample_3_Aligned.sortedByCoord.out,chr9,17606903,17614285,-,10,3,13,known,chr9:17606903-17614285
sample_3_Aligned.sortedByCoord.out,chr7,4520774,4527382,-,9,3,12,known,chr7:4520774-4527382
sample_3_Aligned.sortedByCoord.out,chr17,20105153,20114787,+,6,2,8,known,chr17:20105153-20114787
sample_3_Aligned.sortedByCoord.out,chr15,20311340,20314086,-,11,1,12,known,chr15:20311340-20314086
sample_3_Aligned.sortedByCoord.out,chr16,10993494,10999360,-,9,2,11,known,chr16:10993494-10999360
sample_3_Aligned.sortedByCoord.out,chr21,39512437,39517366,-,14,2,16,known,chr21:39512437-39517366
sample_3_Aligned.sortedByCoord.out,chr21,46833666,46843523,+,13,4,17,novel,chr21:46833666-46843523
sample_3_Aligned.sortedByCoord.out,chr1,47670964,47672968,+,7,1,8,novel,chr1:47670964-47672968
sample_3_Aligned.sortedByCoord.out,chr17,30714727,30719493,-,10,2,12,known,chr17:30714727-30719493
sample_3_Aligned.sortedByCoord.out,chr20,42776983,42777671,+,7,2,9,novel,chr20:42776983-42777671
sample_3_Aligned.sortedByCoord.out,chr19,14314805,14318054,+,9,2,11,known,chr19:14314805-14318054
sample_3_Aligned.sortedByCoord.out,chr9,4560914,4562527,-,14,3,17,known,chr9:4560914-4562527
sample_3_Aligned.sortedByCoord.out,chr9,43309746,43319596,-,6,2,8,novel,chr9:43309746-43319596
sample_3_Aligned.sortedByCoord.out,chr22,5535975,5545190,-,12,2,14,known,chr22:5535975-5545190
sample_3_Aligned.sortedByCoord.out,chr14,30044939,30052973,+,7,1,8,known,chr14:30044939-30052973
sample_3_Aligned.sortedByCoord.out,chr4,2718710,2724579,+,7,4,11,novel,chr4:2718710-2724579
sample_3_Aligned.sortedByCoord.out,chr21,46489086,46496504,-,11,1,12,novel,chr21:46489086-46496504
sample_3_Aligned.sortedByCoord.out,chr11,33004100,33006706,+,13,4,17,novel,chr11:33004100-33006706
sample_3_Aligned.sortedByCoord.out,chr7,44481288,44490144,-,4,1,5,known,chr7:44481288-44490144
sample_3_Aligned.sortedByCoord.out,chr5,1794933,1795925,-,13,2,15,known,chr5:1794933-1795925
sample_3_Aligned.sortedByCoord.out,chr4,8384702,8392368,-,12,0,12,known,chr4:8384702-8392368
sample_3_Aligned.sortedByCoord.out,chr14,20902661,20912387,-,8,0,8,known,chr14:20902661-20912387
sample_3_Aligned.sortedByCoord.out,chr19,47149592,47152256,+,12,3,15,novel,chr19:47149592-47152256
sample_3_Aligned.sortedByCoord.out,chr1,33179909,33182031,+,9,0,9,known,chr1:33179909-33182031
sample_3_Aligned.sortedByCoord.out,chr5,35185968,35186557,+,14,3,17,known,chr5:35185968-35186557
sample_3_Aligned.sortedByCoord.out,chr7,41138571,41143969,+,9,2,11,known,chr7:41138571-41143969
sample_3_Aligned.sortedByCoord.out,chr13,20541879,20542257,+,12,1,13,known,chr13:20541879-20542257
sample_3_Aligned.sortedByCoord.out,chr7,38219042,38224118,-,11,2,13,known,chr7:38219042-38224118
sample_3_Aligned.sortedByCoord.out,chr11,2711480,2719183,-,11,3,14,known,chr11:2711480-2719183
sample_3_Aligned.sortedByCoord.out,chr2,10546156,10552770,+,12,1,13,known,chr2:10546156-10552770
sample_3_Aligned.sortedByCoord.out,chr8,40329728,40339585,+,12,2,14,known,chr8:40329728-40339585
sample_3_Aligned.sortedByCoord.out,chr16,42170946,42173007,-,10,4,14,novel,chr16:42170946-42173007
sample_3_Aligned.sortedByCoord.out,chr14,5565590,5574042,-,15,5,20,known,chr14:5565590-5574042
sample_3_Aligned.sortedByCoord.out,chr8,14909358,14915100,-,18,4,22,known,chr8:14909358-14915100
sample_3_Aligned.sortedByCoord.out,chr15,30461192,30464041,+,13,1,14,known,chr15:30461192-30464041
sample_3_Aligned.sortedByCoord.out,chr14,49059156,49068687,-,9,1,10,known,chr14:49059156-49068687
sample_3_Aligned.sortedByCoord.out,chr19,20704305,20707788,-,12,1,13,known,chr19:20704305-20707788
sample_3_Aligned.sortedByCoord.out,chr6,5842291,5847505,-,10,2,12,known,chr6:5842291-5847505
sample_3_Aligned.sortedByCoord.out,chr9,5117312,5126294,-,6,2,8,known,chr9:5117312-5126294
sample_3_Aligned.sortedByCoord.out,chr6,28789870,28794509,-,10,4,14,known,chr6:28789870-28794509
sample_3_Aligned.sortedByCoord.out,chr19,14927819,14930339,+,8,1,9,known,chr19:14927819-14930339
sample_3_Aligned.sortedByCoord.out,chr20,48194291,48204013,+,10,2,12,known,chr20:48194291-48204013
sample_3_Aligned.sortedByCoord.out,chr13,18729290,18732061,+,4,2,6,novel,chr13:18729290-18732061
sample_3_Aligned.sortedByCoord.out,chr10,39083978,39091969,-,13,1,14,known,chr10:39083978-39091969
sample_3_Aligned.sortedByCoord.out,chr10,44705817,44712608,-,5,2,7,known,chr10:44705817-44712608
sample_3_Aligned.sortedByCoord.out,chr19,25662478,25668531,+,9,2,11,known,chr19:25662478-25668531
sample_3_Aligned.sortedByCoord.out,chr19,36976694,36981004,-,11,2,13,known,chr19:36976694-36981004
sample_3_Aligned.sortedByCoord.out,chr19,13659586,13668637,-,13,3,16,known,chr19:13659586-13668637
sample_3_Aligned.sortedByCoord.out,chr15,6197142,6205352,-,12,3,15,known,chr15:6197142-6205352
sample_3_Aligned.sortedByCoord.out,chr7,32609258,32612972,+,8,1,9,known,chr7:32609258-32612972
sample_3_Aligned.sortedByCoord.out,chr22,36518586,36528009,-,9,3,12,known,chr22:36518586-36528009
sample_3_Aligned.sortedByCoord.out,chr12,17875610,17884203,-,7,1,8,known,chr12:17875610-17884203
sample_3_Aligned.sortedByCoord.out,chr19,3066158,3067236,-,14,1,15,novel,chr19:3066158-3067236
sample_3_Aligned.sortedByCoord.out,chr21,38411177,38418261,+,10,2,12,known,chr21:38411177-38418261
sample_3_Aligned.sortedByCoord.out,chr20,35175819,35176642,-,8,3,11,novel,chr20:35175819-35176642
sample_3_Aligned.sortedByCoord.out,chr17,13707601,13710914,+,8,2,10,known,chr17:13707601-13710914
sample_3_Aligned.sortedByCoord.out,chr19,14902727,14905538,+,14,1,15,novel,chr19:14902727-14905538
sample_3_Aligned.sortedByCoord.out,chr6,46122027,46130356,-,7,2,9,known,chr6:46122027-46130356
sample_3_Aligned.sortedByCoord.out,chr16,7811880,7818138,+,12,2,14,known,chr16:7811880-7818138
sample_3_Aligned.sortedByCoord.out,chr19,10732065,10734422,+,13,2,15,known,chr19:10732065-10734422
sample_3_Aligned.sortedByCoord.out,chr5,35547782,35557381,-,11,1,12,known,chr5:35547782-35557381
sample_3_Aligned.sortedByCoord.out,chr12,2938153,2946583,+,10,0,10,known,chr12:2938153-2946583
sample_3_Aligned.sortedByCoord.out,chr5,22020778,22026330,+,13,2,15,known,chr5:22020778-22026330
sample_3_Aligned.sortedByCoord.out,chr14,32118214,32119957,+,6,1,7,known,chr14:32118214-32119957
sample_3_Aligned.sortedByCoord.out,chr7,47168240,47169639,+,7,0,7,known,chr7:47168240-47169639
sample_3_Aligned.sortedByCoord.out,chr2,41606713,41616495,+,11,2,13,known,chr2:41606713-41616495
sample_3_Aligned.sortedByCoord.out,chr11,40397920,40400725,+,7,2,9,known,chr11:40397920-40400725
sample_3_Aligned.sortedByCoord.out,chr9,36610299,36613112,-,7,1,8,known,chr9:36610299-36613112
sample_3_Aligned.sortedByCoord.out,chr1,33838411,33838823,+,14,1,15,novel,chr1:33838411-33838823
sample_3_Aligned.sortedByCoord.out,chr22,9416211,9418715,+,19,5,24,known,chr22:9416211-9418715
sample_3_Aligned.sortedByCoord.out,chr3,19601717,19603455,-,13,1,14,known,chr3:19601717-19603455
sample_3_Aligned.sortedByCoord.out,chr11,47920259,47927594,-,5,5,10,novel,chr11:47920259-47927594
sample_3_Aligned.sortedByCoord.out,chr19,5701469,5707586,-,8,1,9,novel,chr19:5701469-5707586
sample_3_Aligned.sortedByCoord.out,chr17,30534816,30540678,-,5,2,7,novel,chr17:30534816-30540678
sample_3_Aligned.sortedByCoord.out,chr16,40489008,40492062,-,10,4,14,known,chr16:40489008-40492062
sample_3_Aligned.sortedByCoord.out,chr7,47557707,47565719,+,8,1,9,known,chr7:47557707-47565719
sample_3_Aligned.sortedByCoord.out,chr2,9357756,9363328,+,12,5,17,novel,chr2:9357756-9363328
sample_3_Aligned.sortedByCoord.out,chr18,36415217,36423807,+,9,2,11,known,chr18:36415217-36423807
sample_3_Aligned.sortedByCoord.out,chr1,16290272,16296831,-,8,2,10,known,chr1:16290272-16296831
sample_3_Aligned.sortedByCoord.out,chr18,27901519,27904499,-,4,0,4,novel,chr18:27901519-27904499
sample_3_Aligned.sortedByCoord.out,chr10,28089482,28097380,-,4,3,7,known,chr10:28089482-28097380
sample_3_Aligned.sortedByCoord.out,chr11,45114369,45122256,+,8,3,11,known,chr11:45114369-45122256
sample_3_Aligned.sortedByCoord.out,chr6,43805750,43806180,+,6,4,10,known,chr6:43805750-43806180
sample_3_Aligned.sortedByCoord.out,chr16,24525815,24535154,-,8,2,10,known,chr16:24525815-24535154
sample_3_Aligned.sortedByCoord.out,chr1,29416841,29425052,-,8,1,9,known,chr1:29416841-29425052
sample_3_Aligned.sortedByCoord.out,chr7,27351030,27360335,+,12,3,15,known,chr7:27351030-27360335
sample_3_Aligned.sortedByCoord.out,chr2,42914278,42919740,-,11,4,15,novel,chr2:42914278-42919740
sample_3_Aligned.sortedByCoord.out,chr14,32155656,32162067,+,10,1,11,known,chr14:32155656-32162067
sample_3_Aligned.sortedByCoord.out,chr16,32036772,32041266,+,9,2,11,known,chr16:32036772-32041266
sample_3_Aligned.sortedByCoord.out,chr20,2845761,2849398,+,3,2,5,known,chr20:2845761-2849398
sample_3_Aligned.sortedByCoord.out,chr3,26459347,26463969,+,15,1,16,known,chr3:26459347-26463969
sample_3_Aligned.sortedByCoord.out,chr16,32881102,32890078,-,10,4,14,known,chr16:32881102-32890078
sample_3_Aligned.sortedByCoord.out,chr6,22718106,22721538,+,11,4,15,known,chr6:22718106-22721538
sample_3_Aligned.sortedByCoord.out,chr1,12568002,12574712,+,9,1,10,novel,chr1:12568002-12574712
sample_3_Aligned.sortedByCoord.out,chr6,14818645,14825463,+,18,0,18,known,chr6:14818645-14825463
sample_3_Aligned.sortedByCoord.out,chr9,38336957,38342142,+,13,0,13,known,chr9:38336957-38342142
sample_3_Aligned.sortedByCoord.out,chr18,14615076,14617132,-,10,5,15,known,chr18:14615076-14617132
sample_3_Aligned.sortedByCoord.out,chr3,46483136,46491661,-,9,1,10,novel,chr3:46483136-46491661
sample_3_Aligned.sortedByCoord.out,chr1,48633483,48641497,+,13,4,17,known,chr1:48633483-48641497
sample_3_Aligned.sortedByCoord.out,chr13,48607766,48608233,+,16,3,19,known,chr13:48607766-48608233
sample_3_Aligned.sortedByCoord.out,chr20,13594565,13604122,-,10,3,13,known,chr20:13594565-13604122
sample_3_Aligned.sortedByCoord.out,chr4,11591381,11597244,-,11,0,11,known,chr4:11591381-11597244
sample_3_Aligned.sortedByCoord.out,chr20,30575623,30578132,-,10,3,13,known,chr20:30575623-30578132
sample_3_Aligned.sortedByCoord.out,chr7,15223719,15226246,-,15,2,17,known,chr7:15223719-15226246
sample_3_Aligned.sortedByCoord.out,chr6,19076147,19082232,+,11,0,11,known,chr6:19076147-19082232
sample_3_Aligned.sortedByCoord.out,chr8,35345621,35353769,-,20,1,21,known,chr8:35345621-35353769
sample_3_Aligned.sortedByCoord.out,chr22,13137718,13138764,+,6,0,6,known,chr22:13137718-13138764
sample_3_Aligned.sortedByCoord.out,chr9,6937958,6941077,+,11,4,15,known,chr9:6937958-6941077
sample_3_Aligned.sortedByCoord.out,chr4,24603687,24609079,+,8,4,12,known,chr4:24603687-24609079
sample_3_Aligned.sortedByCoord.out,chr9,17590946,17597635,+,5,3,8,known,chr9:17590946-17597635
sample_3_Aligned.sortedByCoord.out,chr19,39598860,39603820,-,9,0,9,known,chr19:39598860-39603820
sample_3_Aligned.sortedByCoord.out,chr13,9247269,9251905,+,12,2,14,known,chr13:9247269-9251905
sample_3_Aligned.sortedByCoord.out,chr8,6664117,6664742,+,14,1,15,novel,chr8:6664117-6664742
sample_3_Aligned.sortedByCoord.out,chr7,15230183,15230438,+,8,0,8,known,chr7:15230183-15230438
sample_4_Aligned.sortedByCoord.out,chr2,33014826,33021090,-,10,4,14,known,chr2:33014826-33021090
sample_4_Aligned.sortedByCoord.out,chr8,34871152,34879631,+,10,1,11,novel,chr8:34871152-34879631
sample_4_Aligned.sortedByCoord.out,chr4,43738589,43738997,-,10,0,10,known,chr4:43738589-43738997
sample_4_Aligned.sortedByCoord.out,chr4,31874178,31883805,+,20,2,22,known,chr4:31874178-31883805
sample_4_Aligned.sortedByCoord.out,chr15,33695558,33705202,-,11,2,13,known,chr15:33695558-33705202
sample_4_Aligned.sortedByCoord.out,chr6,5743591,5752733,+,17,1,18,known,chr6:5743591-5752733
sample_4_Aligned.sortedByCoord.out,chr5,39162577,39167371,-,8,3,11,known,chr5:39162577-39167371
sample_4_Aligned.sortedByCoord.out,chr9,22508291,22518220,+,6,1,7,known,chr9:22508291-22518220
sample_4_Aligned.sortedByCoord.out,chr12,21719778,21727023,-,6,5,11,novel,chr12:21719778-21727023
sample_4_Aligned.sortedByCoord.out,chr7,45962729,45963501,-,10,1,11,known,chr7:45962729-45963501
sample_4_Aligned.sortedByCoord.out,chr2,31236459,31240972,-,12,2,14,known,chr2:31236459-31240972
sample_4_Aligned.sortedByCoord.out,chr14,17358477,17361235,-,9,1,10,known,chr14:17358477-17361235
sample_4_Aligned.sortedByCoord.out,chr7,34819808,34828255,+,10,2,12,known,chr7:34819808-34828255
sample_4_Aligned.sortedByCoord.out,chr10,13397838,13399377,-,16,0,16,known,chr10:13397838-13399377
sample_4_Aligned.sortedByCoord.out,chr3,35440655,35448563,+,10,3,13,known,chr3:35440655-35448563
sample_4_Aligned.sortedByCoord.out,chr18,15569405,15576543,-,8,2,10,known,chr18:15569405-15576543
sample_4_Aligned.sortedByCoord.out,chr16,46996351,47005274,-,8,1,9,known,chr16:46996351-47005274
sample_4_Aligned.sortedByCoord.out,chr5,17068688,17074311,+,11,3,14,known,chr5:17068688-17074311
sample_4_Aligned.sortedByCoord.out,chr13,40682530,40685250,-,9,3,12,novel,chr13:40682530-40685250
sample_4_Aligned.sortedByCoord.out,chr20,19317868,19322182,+,12,1,13,known,chr20:19317868-19322182
sample_4_Aligned.sortedByCoord.out,chr4,32109946,32115130,-,8,1,9,novel,chr4:32109946-32115130
sample_4_Aligned.sortedByCoord.out,chr10,20949106,20958584,-,8,1,9,known,chr10:20949106-20958584
sample_4_Aligned.sortedByCoord.out,chr1,11894479,11903191,-,6,5,11,known,chr1:11894479-11903191
sample_4_Aligned.sortedByCoord.out,chr22,15562820,15567659,-,12,3,15,known,chr22:15562820-15567659
sample_4_Aligned.sortedByCoord.out,chr8,29598539,29603129,+,10,1,11,known,chr8:29598539-29603129
sample_4_Aligned.sortedByCoord.out,chr3,35071823,35072580,+,4,7,11,known,chr3:35071823-35072580
sample_4_Aligned.sortedByCoord.out,chr16,12686857,12693324,-,11,2,13,known,chr16:12686857-12693324
sample_4_Aligned.sortedByCoord.out,chr19,25646469,25650794,+,11,3,14,novel,chr19:25646469-25650794
sample_4_Aligned.sortedByCoord.out,chr4,36308340,36309670,-,5,3,8,known,chr4:36308340-36309670
sample_4_Aligned.sortedByCoord.out,chr2,11437889,11444525,-,3,3,6,novel,chr2:11437889-11444525
sample_4_Aligned.sortedByCoord.out,chr2,12283806,12285128,-,5,4,9,known,chr2:12283806-12285128
sample_4_Aligned.sortedByCoord.out,chr5,14958681,14958871,+,11,2,13,novel,chr5:14958681-14958871
sample_4_Aligned.sortedByCoord.out,chr4,42838088,42845157,+,11,1,12,known,chr4:42838088-42845157
sample_4_Aligned.sortedByCoord.out,chr20,8162619,8169642,-,14,1,15,novel,chr20:8162619-8169642
sample_4_Aligned.sortedByCoord.out,chr16,16121353,16124778,+,13,0,13,known,chr16:16121353-16124778
sample_4_Aligned.sortedByCoord.out,chr2,48882364,48885043,+,9,3,12,known,chr2:48882364-48885043
sample_4_Aligned.sortedByCoord.out,chr2,4593350,4593564,-,10,1,11,known,chr2:4593350-4593564
sample_4_Aligned.sortedByCoord.out,chr18,8683752,8689134,+,12,1,13,known,chr18:8683752-8689134
sample_4_Aligned.sortedByCoord.out,chr17,25573025,25573353,+,18,1,19,known,chr17:25573025-25573353
sample_4_Aligned.sortedByCoord.out,chr8,12375062,12384477,+,15,3,18,known,chr8:12375062-12384477
sample_4_Aligned.sortedByCoord.out,chr10,41520035,41527032,+,5,1,6,known,chr10:41520035-41527032
sample_4_Aligned.sortedByCoord.out,chr5,25493647,25496001,-,8,1,9,novel,chr5:25493647-25496001
sample_4_Aligned.sortedByCoord.out,chr18,25828050,25828826,+,9,2,11,known,chr18:25828050-25828826
sample_4_Aligned.sortedByCoord.out,chr3,32457167,32460646,+,8,0,8,known,chr3:32457167-32460646
sample_4_Aligned.sortedByCoord.out,chr15,23915888,23917087,+,9,2,11,known,chr15:23915888-23917087
sample_4_Aligned.sortedByCoord.out,chr15,48085007,48086577,+,13,1,14,known,chr15:48085007-48086577
sample_4_Aligned.sortedByCoord.out,chr19,46550666,46556165,+,7,1,8,known,chr19:46550666-46556165
sample_4_Aligned.sortedByCoord.out,chr21,38474469,38475365,-,4,3,7,known,chr21:38474469-38475365
sample_4_Aligned.sortedByCoord.out,chr10,10216614,10220933,-,8,2,10,known,chr10:10216614-10220933
sample_4_Aligned.sortedByCoord.out,chr2,15999318,16008075,-,9,2,11,known,chr2:15999318-16008075
sample_4_Aligned.sortedByCoord.out,chr20,2132099,2137172,+,7,2,9,known,chr20:2132099-2137172
sample_4_Aligned.sortedByCoord.out,chr9,35970872,35974273,+,8,2,10,novel,chr9:35970872-35974273
sample_4_Aligned.sortedByCoord.out,chr13,41938282,41943599,-,8,2,10,known,chr13:41938282-41943599
sample_4_Aligned.sortedByCoord.out,chr14,40253875,40254687,-,13,1,14,known,chr14:40253875-40254687
sample_4_Aligned.sortedByCoord.out,chr9,2212372,2217941,+,18,3,21,novel,chr9:2212372-2217941
sample_4_Aligned.sortedByCoord.out,chr4,28554737,28562198,-,10,1,11,known,chr4:28554737-28562198
sample_4_Aligned.sortedByCoord.out,chr21,43028130,43031906,-,7,2,9,known,chr21:43028130-43031906
sample_4_Aligned.sortedByCoord.out,chr3,34765941,34774901,+,3,3,6,novel,chr3:34765941-34774901
sample_4_Aligned.sortedByCoord.out,chr15,39148268,39154143,-,16,2,18,known,chr15:39148268-39154143
sample_4_Aligned.sortedByCoord.out,chr17,40616391,40619687,+,9,5,14,novel,chr17:40616391-40619687
sample_4_Aligned.sortedByCoord.out,chr2,17180360,17185790,-,11,3,14,known,chr2:17180360-17185790
sample_4_Aligned.sortedByCoord.out,chr4,48312611,48316348,+,11,1,12,known,chr4:48312611-48316348
sample_4_Aligned.sortedByCoord.out,chr1,30783381,30785270,+,19,3,22,known,chr1:30783381-30785270
sample_4_Aligned.sortedByCoord.out,chr3,38699104,38700107,+,14,0,14,known,chr3:38699104-38700107
sample_4_Aligned.sortedByCoord.out,chr20,39086819,39091051,-,8,5,13,known,chr20:39086819-39091051
sample_4_Aligned.sortedByCoord.out,chr20,37793931,37795291,+,15,5,20,known,chr20:37793931-37795291
sample_4_Aligned.sortedByCoord.out,chr18,21407655,21410707,-,12,1,13,known,chr18:21407655-21410707
sample_4_Aligned.sortedByCoord.out,chr9,10467879,10471643,-,12,1,13,known,chr9:10467879-10471643
sample_4_Aligned.sortedByCoord.out,chr1,7555233,7563561,-,11,2,13,known,chr1:7555233-7563561
sample_4_Aligned.sortedByCoord.out,chr14,8354461,8361406,-,11,3,14,known,chr14:8354461-8361406
sample_4_Aligned.sortedByCoord.out,chr1,48703411,48707249,-,10,2,12,known,chr1:48703411-48707249
sample_4_Aligned.sortedByCoord.out,chr9,11699568,11706217,+,14,2,16,known,chr9:11699568-11706217
sample_4_Aligned.sortedByCoord.out,chr4,9443424,9450275,+,12,1,13,known,chr4:9443424-9450275
sample_4_Aligned.sortedByCoord.out,chr5,27814436,27818514,-,11,1,12,novel,chr5:27814436-27818514
sample_4_Aligned.sortedByCoord.out,chr3,38529448,38538786,-,12,2,14,known,chr3:38529448-38538786
sample_4_Aligned.sortedByCoord.out,chr13,23314973,23316334,+,8,3,11,known,chr13:23314973-23316334
sample_4_Aligned.sortedByCoord.out,chr2,45602626,45606483,+,4,3,7,novel,chr2:45602626-45606483
sample_4_Aligned.sortedByCoord.out,chr1,22642818,22647540,+,10,2,12,known,chr1:22642818-22647540
sample_4_Aligned.sortedByCoord.out,chr21,6513508,6523072,-,8,1,9,known,chr21:6513508-6523072
sample_4_Aligned.sortedByCoord.out,chr19,46122574,46125028,+,8,2,10,known,chr19:46122574-46125028
sample_4_Aligned.sortedByCoord.out,chr14,5804710,5813752,+,10,1,11,novel,chr14:5804710-5813752
sample_4_Aligned.sortedByCoord.out,chr21,42081183,42090060,+,11,2,13,known,chr21:42081183-42090060
sample_4_Aligned.sortedByCoord.out,chr3,3985195,3985889,-,12,0,12,known,chr3:3985195-3985889
sample_4_Aligned.sortedByCoord.out,chr22,12708753,12718561,+,9,3,12,known,chr22:12708753-12718561
sample_4_Aligned.sortedByCoord.out,chr9,9865459,9868641,+,11,1,12,known,chr9:9865459-9868641
sample_4_Aligned.sortedByCoord.out,chr12,30519927,30520371,+,18,1,19,known,chr12:30519927-30520371
sample_4_Aligned.sortedByCoord.out,chr2,46260687,46264721,-,10,0,10,known,chr2:46260687-46264721
sample_4_Aligned.sortedByCoord.out,chr11,8483013,8490051,-,13,1,14,known,chr11:8483013-8490051
sample_4_Aligned.sortedByCoord.out,chr20,42632041,42637163,+,8,1,9,known,chr20:42632041-42637163
sample_4_Aligned.sortedByCoord.out,chr22,47902128,47907583,-,9,0,9,known,chr22:47902128-47907583
sample_4_Aligned.sortedByCoord.out,chr7,39363697,39366640,-,8,1,9,novel,chr7:39363697-39366640
sample_4_Aligned.sortedByCoord.out,chr16,41409969,41415488,-,6,0,6,novel,chr16:41409969-41415488
sample_4_Aligned.sortedByCoord.out,chr5,47105897,47111191,-,13,3,16,known,chr5:47105897-47111191
sample_4_Aligned.sortedByCoord.out,chr17,38923813,38924215,-,13,3,16,known,chr17:38923813-38924215
sample_4_Aligned.sortedByCoord.out,chr14,46089495,46092148,-,12,0,12,known,chr14:46089495-46092148
sample_4_Aligned.sortedByCoord.out,chr6,31882195,31885206,-,12,0,12,known,chr6:31882195-31885206
sample_4_Aligned.sortedByCoord.out,chr13,13034360,13040852,-,8,2,10,novel,chr13:13034360-13040852
sample_4_Aligned.sortedByCoord.out,chr2,42193169,42196136,+,9,3,12,known,chr2:42193169-42196136
sample_4_Aligned.sortedByCoord.out,chr8,44739109,44744154,+,1,1,2,known,chr8:44739109-44744154
sample_4_Aligned.sortedByCoord.out,chr12,47673896,47683666,-,11,2,13,known,chr12:47673896-47683666
sample_4_Aligned.sortedByCoord.out,chr19,38568861,38573962,+,11,3,14,known,chr19:38568861-38573962
sample_4_Aligned.sortedByCoord.out,chr12,1735504,1744157,-,12,3,15,known,chr12:1735504-1744157
sample_4_Aligned.sortedByCoord.out,chr18,31619628,31628538,+,7,0,7,known,chr18:31619628-31628538
sample_4_Aligned.sortedByCoord.out,chr19,11202454,11204907,-,8,3,11,novel,chr19:11202454-11204907
sample_4_Aligned.sortedByCoord.out,chr8,49583030,49590191,+,8,2,10,novel,chr8:49583030-49590191
sample_4_Aligned.sortedByCoord.out,chr8,6161262,6166820,+,3,2,5,known,chr8:6161262-6166820
sample_4_Aligned.sortedByCoord.out,chr22,49708910,49717391,+,11,1,12,known,chr22:49708910-49717391
sample_4_Aligned.sortedByCoord.out,chr5,19077546,19083205,+,8,3,11,known,chr5:19077546-19083205
sample_4_Aligned.sortedByCoord.out,chr6,1122003,1125793,+,5,1,6,known,chr6:1122003-1125793
sample_4_Aligned.sortedByCoord.out,chr9,48088041,48088263,+,6,4,10,known,chr9:48088041-48088263
sample_4_Aligned.sortedByCoord.out,chr13,10912494,10917903,-,8,4,12,known,chr13:10912494-10917903
sample_4_Aligned.sortedByCoord.out,chr9,22287267,22296365,-,10,5,15,known,chr9:22287267-22296365
sample_4_Aligned.sortedByCoord.out,chr2,45261660,45268567,-,10,2,12,known,chr2:45261660-45268567
sample_4_Aligned.sortedByCoord.out,chr22,27071804,27080361,+,7,0,7,known,chr22:27071804-27080361
sample_4_Aligned.sortedByCoord.out,chr19,30353647,30356605,-,11,2,13,known,chr19:30353647-30356605
sample_4_Aligned.sortedByCoord.out,chr20,38930899,38940533,-,12,4,16,known,chr20:38930899-38940533
sample_4_Aligned.sortedByCoord.out,chr9,45375958,45381904,-,7,1,8,known,chr9:45375958-45381904
sample_4_Aligned.sortedByCoord.out,chr15,23123945,23130856,-,11,1,12,known,chr15:23123945-23130856
sample_4_Aligned.sortedByCoord.out,chr10,25631985,25636772,-,15,5,20,known,chr10:25631985-25636772
sample_4_Aligned.sortedByCoord.out,chr13,47024782,47030674,+,8,1,9,known,chr13:47024782-47030674
sample_4_Aligned.sortedByCoord.out,chr16,25229112,25231602,-,7,3,10,known,chr16:25229112-25231602
sample_4_Aligned.sortedByCoord.out,chr9,36844793,36853076,+,12,1,13,known,chr9:36844793-36853076
sample_4_Aligned.sortedByCoord.out,chr7,27565346,27570526,+,12,3,15,known,chr7:27565346-27570526
sample_4_Aligned.sortedByCoord.out,chr15,20146055,20146203,-,11,3,14,known,chr15:20146055-20146203
sample_4_Aligned.sortedByCoord.out,chr7,8506792,8508132,-,10,2,12,known,chr7:8506792-8508132
sample_4_Aligned.sortedByCoord.out,chr14,4277552,4281127,-,11,1,12,known,chr14:4277552-4281127
sample_4_Aligned.sortedByCoord.out,chr21,42205675,42210065,+,8,4,12,novel,chr21:42205675-42210065
sample_4_Aligned.sortedByCoord.out,chr13,36250274,36251475,-,12,2,14,known,chr13:36250274-36251475
sample_4_Aligned.sortedByCoord.out,chr16,47292620,47295894,+,10,3,13,novel,chr16:47292620-47295894
sample_4_Aligned.sortedByCoord.out,chr12,6938675,6941638,-,6,1,7,known,chr12:6938675-6941638
sample_4_Aligned.sortedByCoord.out,chr12,47435439,47444000,+,11,1,12,known,chr12:47435439-47444000
sample_4_Aligned.sortedByCoord.out,chr15,19554716,19559148,-,8,3,11,known,chr15:19554716-19559148
sample_4_Aligned.sortedByCoord.out,chr19,12605119,12606469,+,14,0,14,novel,chr19:12605119-12606469
sample_4_Aligned.sortedByCoord.out,chr4,40683391,40690753,-,13,2,15,known,chr4:40683391-40690753
sample_4_Aligned.sortedByCoord.out,chr15,45751900,45754545,+,7,2,9,novel,chr15:45751900-45754545
sample_4_Aligned.sortedByCoord.out,chr18,27562705,27566334,+,10,2,12,known,chr18:27562705-27566334
sample_4_Aligned.sortedByCoord.out,chr10,28022270,28027604,-,9,3,12,known,chr10:28022270-28027604
sample_4_Aligned.sortedByCoord.out,chr11,48048779,48054533,+,14,4,18,novel,chr11:48048779-48054533
sample_4_Aligned.sortedByCoord.out,chr7,22899045,22900860,-,7,2,9,known,chr7:22899045-22900860
sample_4_Aligned.sortedByCoord.out,chr6,21257535,21261277,+,10,1,11,novel,chr6:21257535-21261277
sample_4_Aligned.sortedByCoord.out,chr10,11890316,11897334,-,10,0,10,known,chr10:11890316-11897334
sample_4_Aligned.sortedByCoord.out,chr21,14754282,14754535,+,14,1,15,known,chr21:14754282-14754535
sample_4_Aligned.sortedByCoord.out,chr10,19679627,19685448,-,11,6,17,known,chr10:19679627-19685448
sample_4_Aligned.sortedByCoord.out,chr6,8515420,8518115,+,9,1,10,known,chr6:8515420-8518115
sample_4_Aligned.sortedByCoord.out,chr2,13674808,13680038,-,12,1,13,known,chr2:13674808-13680038
sample_4_Aligned.sortedByCoord.out,chr11,43317234,43320523,+,10,0,10,known,chr11:43317234-43320523
sample_4_Aligned.sortedByCoord.out,chr18,14163266,14168906,+,17,3,20,known,chr18:14163266-14168906
sample_4_Aligned.sortedByCoord.out,chr17,42248931,42250086,+,8,2,10,novel,chr17:42248931-42250086
sample_4_Aligned.sortedByCoord.out,chr4,35309774,35317726,+,10,3,13,known,chr4:35309774-35317726
sample_4_Aligned.sortedByCoord.out,chr3,8605805,8608086,+,14,1,15,known,chr3:8605805-8608086
sample_4_Aligned.sortedByCoord.out,chr7,30679104,30679894,-,7,2,9,known,chr7:30679104-30679894
sample_4_Aligned.sortedByCoord.out,chr15,33830945,33833179,+,9,4,13,known,chr15:33830945-33833179
sample_4_Aligned.sortedByCoord.out,chr21,17414544,17419735,-,8,4,12,novel,chr21:17414544-17419735
sample_4_Aligned.sortedByCoord.out,chr9,16086179,16093636,+,6,3,9,novel,chr9:16086179-16093636
sample_4_Aligned.sortedByCoord.out,chr13,15531197,15537404,+,6,4,10,known,chr13:15531197-15537404
sample_4_Aligned.sortedByCoord.out,chr18,40955281,40958520,-,9,7,16,known,chr18:40955281-40958520
sample_4_Aligned.sortedByCoord.out,chr13,45645562,45651963,+,7,1,8,known,chr13:45645562-45651963
sample_4_Aligned.sortedByCoord.out,chr20,41414818,41415073,-,16,3,19,known,chr20:41414818-41415073
sample_4_Aligned.sortedByCoord.out,chr21,4743401,4748010,-,5,3,8,known,chr21:4743401-4748010
sample_4_Aligned.sortedByCoord.out,chr22,32611735,32617974,-,8,2,10,known,chr22:32611735-32617974
sample_4_Aligned.sortedByCoord.out,chr21,21542681,21547232,+,9,3,12,novel,chr21:21542681-21547232
sample_4_Aligned.sortedByCoord.out,chr9,14377144,14384385,+,7,2,9,known,chr9:14377144-14384385
sample_4_Aligned.sortedByCoord.out,chr20,45949120,45949773,-,7,0,7,known,chr20:45949120-45949773
sample_4_Aligned.sortedByCoord.out,chr12,41983938,41990147,-,8,2,10,known,chr12:41983938-41990147
sample_4_Aligned.sortedByCoord.out,chr3,47644676,47649754,-,9,0,9,known,chr3:47644676-47649754
sample_4_Aligned.sortedByCoord.out,chr10,47472908,47475178,+,10,5,15,known,chr10:47472908-47475178
sample_4_Aligned.sortedByCoord.out,chr2,4717605,4718052,-,12,5,17,novel,chr2:4717605-4718052
sample_4_Aligned.sortedByCoord.out,chr5,37151197,37159508,+,11,5,16,known,chr5:37151197-37159508
sample_4_Aligned.sortedByCoord.out,chr14,44923503,44927754,+,11,1,12,known,chr14:44923503-44927754
sample_4_Aligned.sortedByCoord.out,chr15,6880127,6888128,+,5,3,8,known,chr15:6880127-6888128
sample_4_Aligned.sortedByCoord.out,chr18,46425399,46435111,+,5,5,10,known,chr18:46425399-46435111
sample_4_Aligned.sortedByCoord.out,chr8,38652504,38660464,+,7,1,8,known,chr8:38652504-38660464
sample_4_Aligned.sortedByCoord.out,chr12,11005092,11006225,-,11,0,11,known,chr12:11005092-11006225
sample_4_Aligned.sortedByCoord.out,chr9,33412930,33415081,-,8,3,11,known,chr9:33412930-33415081
sample_4_Aligned.sortedByCoord.out,chr3,41654732,41657959,-,11,2,13,known,chr3:41654732-41657959
sample_4_Aligned.sortedByCoord.out,chr6,17078111,17085674,+,10,1,11,known,chr6:17078111-17085674
sample_4_Aligned.sortedByCoord.out,chr6,26969067,26969197,-,7,1,8,known,chr6:26969067-26969197
sample_4_Aligned.sortedByCoord.out,chr18,49447094,49452478,+,12,5,17,known,chr18:49447094-49452478
sample_4_Aligned.sortedByCoord.out,chr2,44168832,44174675,-,10,3,13,known,chr2:44168832-44174675
sample_4_Aligned.sortedByCoord.out,chr19,49805206,49806284,-,10,1,11,known,chr19:49805206-49806284
sample_4_Aligned.sortedByCoord.out,chr18,45795130,45803474,+,11,3,14,known,chr18:45795130-45803474
sample_4_Aligned.sortedByCoord.out,chr20,7685492,7692045,+,8,1,9,novel,chr20:7685492-7692045
sample_4_Aligned.sortedByCoord.out,chr9,36369493,36374209,-,9,2,11,known,chr9:36369493-36374209
sample_4_Aligned.sortedByCoord.out,chr17,16498346,16503875,-,10,0,10,known,chr17:16498346-16503875
sample_4_Aligned.sortedByCoord.out,chr20,5024741,5031352,+,17,1,18,novel,chr20:5024741-5031352
sample_4_Aligned.sortedByCoord.out,chr13,32011731,32014244,-,10,2,12,known,chr13:32011731-32014244
sample_4_Aligned.sortedByCoord.out,chr12,19255936,19265197,-,14,2,16,known,chr12:19255936-19265197
sample_4_Aligned.sortedByCoord.out,chr11,18548765,18552251,+,14,0,14,novel,chr11:18548765-18552251
sample_4_Aligned.sortedByCoord.out,chr2,11876773,11884281,+,8,1,9,known,chr2:11876773-11884281
sample_4_Aligned.sortedByCoord.out,chr7,29968993,29976513,+,13,1,14,known,chr7:29968993-29976513
sample_4_Aligned.sortedByCoord.out,chr7,21805426,21814122,-,10,1,11,known,chr7:21805426-21814122
sample_4_Aligned.sortedByCoord.out,chr4,23933573,23937190,+,14,1,15,known,chr4:23933573-23937190
sample_4_Aligned.sortedByCoord.out,chr10,34566528,34567407,+,7,3,10,novel,chr10:34566528-34567407
sample_4_Aligned.sortedByCoord.out,chr21,35265908,35275761,+,8,1,9,novel,chr21:35265908-35275761
sample_4_Aligned.sortedByCoord.out,chr8,32864720,32866206,-,6,3,9,novel,chr8:32864720-32866206
sample_4_Aligned.sortedByCoord.out,chr7,15979583,15986010,+,10,3,13,known,chr7:15979583-15986010
sample_4_Aligned.sortedByCoord.out,chr21,18478166,18487144,+,8,4,12,known,chr21:18478166-18487144
sample_4_Aligned.sortedByCoord.out,chr15,8956029,8956800,-,7,6,13,known,chr15:8956029-8956800
sample_4_Aligned.sortedByCoord.out,chr20,4051701,4056646,+,17,4,21,novel,chr20:4051701-4056646
sample_4_Aligned.sortedByCoord.out,chr5,25321958,25331607,-,17,2,19,known,chr5:25321958-25331607
sample_4_Aligned.sortedByCoord.out,chr6,19521573,19528701,-,5,2,7,known,chr6:19521573-19528701
sample_4_Aligned.sortedByCoord.out,chr22,30103335,30111821,-,3,4,7,known,chr22:30103335-30111821
sample_4_Aligned.sortedByCoord.out,chr5,23961129,23967065,-,12,0,12,novel,chr5:23961129-23967065
sample_4_Aligned.sortedByCoord.out,chr22,41675512,41684597,+,9,1,10,known,chr22:41675512-41684597
sample_4_Aligned.sortedByCoord.out,chr13,8661056,8665742,-,14,2,16,known,chr13:8661056-8665742
sample_4_Aligned.sortedByCoord.out,chr19,25605461,25609329,+,10,2,12,known,chr19:25605461-25609329
sample_4_Aligned.sortedByCoord.out,chr10,26669115,26670588,+,9,0,9,known,chr10:26669115-26670588
sample_4_Aligned.sortedByCoord.out,chr3,45346984,45351765,-,7,0,7,known,chr3:45346984-45351765
sample_4_Aligned.sortedByCoord.out,chr18,32763740,32764373,+,10,0,10,known,chr18:32763740-32764373
sample_4_Aligned.sortedByCoord.out,chr12,33290025,33297923,+,17,1,18,known,chr12:33290025-33297923
sample_4_Aligned.sortedByCoord.out,chr5,33710641,33714097,+,9,0,9,known,chr5:33710641-33714097
sample_4_Aligned.sortedByCoord.out,chr22,28705982,28712852,-,12,0,12,known,chr22:28705982-28712852
sample_4_Aligned.sortedByCoord.out,chr19,32718529,32722895,+,12,4,16,novel,chr19:32718529-32722895
sample_4_Aligned.sortedByCoord.out,chr19,15827257,15834987,-,10,2,12,novel,chr19:15827257-15834987
sample_4_Aligned.sortedByCoord.out,chr22,20982177,20984003,-,13,2,15,known,chr22:20982177-20984003
sample_4_Aligned.sortedByCoord.out,chr17,41690483,41691657,+,6,0,6,known,chr17:41690483-41691657
sample_4_Aligned.sortedByCoord.out,chr20,34813042,34820170,+,15,2,17,novel,chr20:34813042-34820170
sample_4_Aligned.sortedByCoord.out,chr5,20126171,20132976,+,11,3,14,novel,chr5:20126171-20132976
sample_4_Aligned.sortedByCoord.out,chr21,30093246,30095746,+,10,3,13,novel,chr21:30093246-30095746
sample_4_Aligned.sortedByCoord.out,chr15,38900097,38901441,+,7,1,8,novel,chr15:38900097-38901441
sample_4_Aligned.sortedByCoord.out,chr7,6210886,6211072,+,9,3,12,known,chr7:6210886-6211072
sample_4_Aligned.sortedByCoord.out,chr1,33019841,33028337,-,7,1,8,known,chr1:33019841-33028337
sample_4_Aligned.sortedByCoord.out,chr10,31652348,31658560,+,12,1,13,known,chr10:31652348-31658560
sample_4_Aligned.sortedByCoord.out,chr1,6755187,6764069,+,12,5,17,known,chr1:6755187-6764069
sample_4_Aligned.sortedByCoord.out,chr8,1707279,1710416,+,8,1,9,known,chr8:1707279-1710416
sample_4_Aligned.sortedByCoord.out,chr11,18248385,18251202,+,13,2,15,known,chr11:18248385-18251202
sample_4_Aligned.sortedByCoord.out,chr6,6252726,6258207,-,12,3,15,known,chr6:6252726-6258207
sample_4_Aligned.sortedByCoord.out,chr1,48501226,48507096,-,9,3,12,known,chr1:48501226-48507096
sample_4_Aligned.sortedByCoord.out,chr17,41364704,41372107,+,4,5,9,novel,chr17:41364704-41372107
sample_4_Aligned.sortedByCoord.out,chr21,37451698,37456625,+,8,1,9,known,chr21:37451698-37456625
sample_4_Aligned.sortedByCoord.out,chr16,27863030,27865747,-,11,0,11,known,chr16:27863030-27865747
sample_4_Aligned.sortedByCoord.out,chr6,4490137,4498319,+,14,1,15,novel,chr6:4490137-4498319
sample_4_Aligned.sortedByCoord.out,chr14,1683948,1693147,-,6,0,6,known,chr14:1683948-1693147
sample_4_Aligned.sortedByCoord.out,chr11,39946406,39953201,-,8,5,13,known,chr11:39946406-39953201
sample_4_Aligned.sortedByCoord.out,chr11,38680106,38680629,+,12,2,14,known,chr11:38680106-38680629
sample_4_Aligned.sortedByCoord.out,chr13,14254507,14255238,+,9,2,11,known,chr13:14254507-14255238
sample_4_Aligned.sortedByCoord.out,chr6,13289508,13290566,-,14,1,15,known,chr6:13289508-13290566
sample_4_Aligned.sortedByCoord.out,chr16,27133590,27135004,+,9,4,13,known,chr16:27133590-27135004
sample_4_Aligned.sortedByCoord.out,chr18,2078708,2081118,+,12,2,14,known,chr18:2078708-2081118
sample_4_Aligned.sortedByCoord.out,chr22,12389125,12395004,-,7,3,10,known,chr22:12389125-12395004
sample_4_Aligned.sortedByCoord.out,chr12,26764308,26769319,-,11,3,14,known,chr12:26764308-26769319
sample_4_Aligned.sortedByCoord.out,chr21,4512683,4520573,+,8,1,9,known,chr21:4512683-4520573
sample_4_Aligned.sortedByCoord.out,chr8,43807474,43812546,-,11,1,12,novel,chr8:43807474-43812546
sample_4_Aligned.sortedByCoord.out,chr12,5520123,5526446,+,7,2,9,novel,chr12:5520123-5526446
sample_4_Aligned.sortedByCoord.out,chr12,4124909,4134564,+,8,1,9,known,chr12:4124909-4134564
sample_4_Aligned.sortedByCoord.out,chr8,49231058,49234887,-,11,1,12,known,chr8:49231058-49234887
sample_4_Aligned.sortedByCoord.out,chr9,12464659,12471660,-,9,0,9,known,chr9:12464659-12471660
sample_4_Aligned.sortedByCoord.out,chr15,30774091,30775103,-,13,2,15,known,chr15:30774091-30775103
sample_4_Aligned.sortedByCoord.out,chr18,36752397,36752856,+,12,0,12,novel,chr18:36752397-36752856
sample_4_Aligned.sortedByCoord.out,chr12,24326794,24327256,-,8,0,8,known,chr12:24326794-24327256
sample_4_Aligned.sortedByCoord.out,chr6,1620920,1623001,-,12,2,14,known,chr6:1620920-1623001
sample_4_Aligned.sortedByCoord.out,chr5,21593819,21600611,-,8,3,11,known,chr5:21593819-21600611
sample_4_Aligned.sortedByCoord.out,chr14,48521630,48531173,+,14,0,14,known,chr14:48521630-48531173
sample_4_Aligned.sortedByCoord.out,chr15,5375546,5379044,+,8,2,10,known,chr15:5375546-5379044
sample_4_Aligned.sortedByCoord.out,chr9,17256559,17258964,-,12,4,16,known,chr9:17256559-17258964
sample_4_Aligned.sortedByCoord.out,chr19,38253666,38257793,-,15,2,17,novel,chr19:38253666-38257793
sample_4_Aligned.sortedByCoord.out,chr5,37434903,37439240,+,12,1,13,known,chr5:37434903-37439240
sample_4_Aligned.sortedByCoord.out,chr8,23333056,23341024,+,2,1,3,known,chr8:23333056-23341024
sample_4_Aligned.sortedByCoord.out,chr12,4642273,4644571,+,9,3,12,known,chr12:4642273-4644571
sample_4_Aligned.sortedByCoord.out,chr21,39279790,39289005,-,14,6,20,known,chr21:39279790-39289005
sample_4_Aligned.sortedByCoord.out,chr12,28596881,28602301,-,9,2,11,known,chr12:28596881-28602301
sample_4_Aligned.sortedByCoord.out,chr20,33640993,33642504,+,8,2,10,novel,chr20:33640993-33642504
sample_4_Aligned.sortedByCoord.out,chr4,1718731,1724428,+,12,2,14,novel,chr4:1718731-1724428
sample_4_Aligned.sortedByCoord.out,chr14,27558093,27560833,-,12,5,17,novel,chr14:27558093-27560833
sample_4_Aligned.sortedByCoord.out,chr21,32158283,32165620,+,10,3,13,known,chr21:32158283-32165620
sample_4_Aligned.sortedByCoord.out,chr5,44615867,44624965,+,10,2,12,known,chr5:44615867-44624965
sample_4_Aligned.sortedByCoord.out,chr22,40237809,40246896,+,9,2,11,novel,chr22:40237809-40246896
sample_4_Aligned.sortedByCoord.out,chr11,25623525,25633498,+,10,3,13,known,chr11:25623525-25633498
sample_4_Aligned.sortedByCoord.out,chr1,28041256,28046880,-,16,1,17,known,chr1:28041256-28046880
sample_4_Aligned.sortedByCoord.out,chr11,22476438,22486056,-,11,2,13,known,chr11:22476438-22486056
sample_4_Aligned.sortedByCoord.out,chr5,16751105,16751342,+,6,0,6,known,chr5:16751105-16751342
sample_4_Aligned.sortedByCoord.out,chr21,8646631,8649084,+,10,4,14,known,chr21:8646631-8649084
sample_4_Aligned.sortedByCoord.out,chr9,37787974,37788286,+,11,1,12,known,chr9:37787974-37788286
sample_4_Aligned.sortedByCoord.out,chr13,48212036,48218901,-,10,3,13,known,chr13:48212036-48218901
sample_4_Aligned.sortedByCoord.out,chr2,10783304,10788726,+,13,1,14,novel,chr2:10783304-10788726
sample_4_Aligned.sortedByCoord.out,chr14,22088077,22092410,-,9,2,11,known,chr14:22088077-22092410
sample_4_Aligned.sortedByCoord.out,chr1,29561164,29565954,+,10,3,13,novel,chr1:29561164-29565954
sample_4_Aligned.sortedByCoord.out,chr21,5313059,5321287,+,10,3,13,known,chr21:5313059-5321287
sample_4_Aligned.sortedByCoord.out,chr15,38836102,38843430,-,10,2,12,known,chr15:38836102-38843430
sample_4_Aligned.sortedByCoord.out,chr4,20275140,20279538,+,13,3,16,known,chr4:20275140-20279538
sample_4_Aligned.sortedByCoord.out,chr10,35002522,35008784,-,7,2,9,known,chr10:35002522-35008784
sample_4_Aligned.sortedByCoord.out,chr15,16391348,16394349,-,10,1,11,known,chr15:16391348-16394349
sample_4_Aligned.sortedByCoord.out,chr22,47181839,47189336,+,11,1,12,novel,chr22:47181839-47189336
sample_4_Aligned.sortedByCoord.out,chr7,11665049,11666493,-,10,3,13,novel,chr7:11665049-11666493
sample_4_Aligned.sortedByCoord.out,chr2,9280238,9285669,+,6,2,8,known,chr2:9280238-9285669
sample_4_Aligned.sortedByCoord.out,chr10,40474277,40478266,-,11,3,14,novel,chr10:40474277-40478266
sample_4_Aligned.sortedByCoord.out,chr6,33395964,33398553,-,8,3,11,known,chr6:33395964-33398553
sample_4_Aligned.sortedByCoord.out,chr2,25340144,25344281,-,9,2,11,known,chr2:25340144-25344281
sample_4_Aligned.sortedByCoord.out,chr12,13669378,13673172,+,17,4,21,novel,chr12:13669378-13673172
sample_4_Aligned.sortedByCoord.out,chr1,15814723,15823352,+,11,2,13,known,chr1:15814723-15823352
sample_4_Aligned.sortedByCoord.out,chr2,49625091,49627438,-,11,0,11,known,chr2:49625091-49627438
sample_4_Aligned.sortedByCoord.out,chr4,39219277,39225499,+,12,4,16,known,chr4:39219277-39225499
sample_4_Aligned.sortedByCoord.out,chr11,22618239,22621203,+,10,4,14,known,chr11:22618239-22621203
sample_4_Aligned.sortedByCoord.out,chr12,28098670,28107566,+,10,3,13,known,chr12:28098670-28107566
sample_4_Aligned.sortedByCoord.out,chr22,48823933,48824815,+,9,2,11,known,chr22:48823933-48824815
sample_4_Aligned.sortedByCoord.out,chr19,42531786,42540425,+,8,6,14,known,chr19:42531786-42540425
sample_4_Aligned.sortedByCoord.out,chr6,35088659,35096312,-,7,2,9,known,chr6:35088659-35096312
sample_4_Aligned.sortedByCoord.out,chr17,18682086,18683679,+,8,1,9,known,chr17:18682086-18683679
sample_4_Aligned.sortedByCoord.out,chr22,32524376,32532455,+,8,1,9,known,chr22:32524376-32532455
sample_4_Aligned.sortedByCoord.out,chr22,35716164,35716969,+,9,1,10,known,chr22:35716164-35716969
sample_4_Aligned.sortedByCoord.out,chr7,19894872,19897141,+,5,4,9,known,chr7:19894872-19897141
sample_4_Aligned.sortedByCoord.out,chr12,33018496,33022404,-,12,0,12,novel,chr12:33018496-33022404
sample_4_Aligned.sortedByCoord.out,chr17,13414885,13423013,-,17,2,19,known,chr17:13414885-13423013
sample_4_Aligned.sortedByCoord.out,chr8,8081575,8086463,+,6,0,6,known,chr8:8081575-8086463
sample_4_Aligned.sortedByCoord.out,chr7,5928241,5937728,-,9,1,10,known,chr7:5928241-5937728
sample_4_Aligned.sortedByCoord.out,chr4,25138771,25145539,-,7,2,9,known,chr4:25138771-25145539
sample_4_Aligned.sortedByCoord.out,chr12,41518065,41519336,-,5,0,5,known,chr12:41518065-41519336
sample_4_Aligned.sortedByCoord.out,chr11,16702714,16705605,+,10,0,10,known,chr11:16702714-16705605
sample_4_Aligned.sortedByCoord.out,chr9,4172868,4177066,-,11,2,13,known,chr9:4172868-4177066
sample_4_Aligned.sortedByCoord.out,chr6,4428823,4436878,-,6,5,11,known,chr6:4428823-4436878
sample_4_Aligned.sortedByCoord.out,chr20,15718790,15728192,-,9,1,10,novel,chr20:15718790-15728192
sample_4_Aligned.sortedByCoord.out,chr17,32904003,32911913,-,8,0,8,novel,chr17:32904003-32911913
sample_4_Aligned.sortedByCoord.out,chr6,41813001,41821441,+,11,2,13,known,chr6:41813001-41821441
sample_4_Aligned.sortedByCoord.out,chr14,24212736,24212928,+,4,1,5,novel,chr14:24212736-24212928
sample_4_Aligned.sortedByCoord.out,chr11,24103449,24113183,-,8,3,11,known,chr11:24103449-24113183
sample_4_Aligned.sortedByCoord.out,chr3,7938450,7947935,+,7,2,9,known,chr3:7938450-7947935
sample_4_Aligned.sortedByCoord.out,chr11,26402054,26404988,+,12,2,14,known,chr11:26402054-26404988
sample_4_Aligned.sortedByCoord.out,chr17,43819767,43822952,-,6,1,7,known,chr17:43819767-43822952
sample_4_Aligned.sortedByCoord.out,chr17,3014837,3016446,-,15,1,16,known,chr17:3014837-3016446
sample_4_Aligned.sortedByCoord.out,chr6,17796977,17806080,+,11,2,13,novel,chr6:17796977-17806080
sample_4_Aligned.sortedByCoord.out,chr5,19493401,19497967,+,11,1,12,novel,chr5:19493401-19497967
sample_4_Aligned.sortedByCoord.out,chr1,13687282,13688395,+,13,2,15,known,chr1:13687282-13688395
sample_4_Aligned.sortedByCoord.out,chr12,22102141,22108391,+,10,1,11,known,chr12:22102141-22108391
sample_4_Aligned.sortedByCoord.out,chr14,39982791,39990804,+,11,2,13,known,chr14:39982791-39990804
sample_4_Aligned.sortedByCoord.out,chr5,39654891,39659830,-,13,1,14,known,chr5:39654891-39659830
sample_4_Aligned.sortedByCoord.out,chr19,1827174,1836462,-,12,3,15,known,chr19:1827174-1836462
sample_4_Aligned.sortedByCoord.out,chr2,13669889,13675061,-,8,0,8,known,chr2:13669889-13675061
sample_4_Aligned.sortedByCoord.out,chr12,3294204,3296121,-,10,1,11,known,chr12:3294204-3296121
sample_4_Aligned.sortedByCoord.out,chr7,46842976,46850868,+,11,0,11,known,chr7:46842976-46850868
sample_4_Aligned.sortedByCoord.out,chr1,42358130,42360247,+,4,1,5,known,chr1:42358130-42360247
sample_4_Aligned.sortedByCoord.out,chr13,4827849,4829566,+,9,3,12,novel,chr13:4827849-4829566
sample_4_Aligned.sortedByCoord.out,chr4,14554206,14554704,-,7,0,7,known,chr4:14554206-14554704
sample_4_Aligned.sortedByCoord.out,chr10,33437300,33440355,+,15,2,17,novel,chr10:33437300-33440355
sample_4_Aligned.sortedByCoord.out,chr17,7657043,7662992,+,5,2,7,known,chr17:7657043-7662992
sample_4_Aligned.sortedByCoord.out,chr20,1010814,1016269,-,8,1,9,known,chr20:1010814-1016269
sample_4_Aligned.sortedByCoord.out,chr18,24924999,24928144,-,8,1,9,known,chr18:24924999-24928144
sample_4_Aligned.sortedByCoord.out,chr4,9452388,9454854,-,8,3,11,known,chr4:9452388-9454854
sample_4_Aligned.sortedByCoord.out,chr8,30635539,30637665,-,6,1,7,known,chr8:30635539-30637665
sample_4_Aligned.sortedByCoord.out,chr8,2521913,2529899,+,6,3,9,known,chr8:2521913-2529899
sample_4_Aligned.sortedByCoord.out,chr18,23257503,23265038,+,8,5,13,known,chr18:23257503-23265038
sample_4_Aligned.sortedByCoord.out,chr21,22270326,22275529,-,8,2,10,known,chr21:22270326-22275529
sample_4_Aligned.sortedByCoord.out,chr14,38455309,38457017,+,8,1,9,known,chr14:38455309-38457017
sample_4_Aligned.sortedByCoord.out,chr5,12787284,12790494,+,5,4,9,novel,chr5:12787284-12790494
sample_4_Aligned.sortedByCoord.out,chr11,46083279,46087570,-,15,1,16,novel,chr11:46083279-46087570
sample_4_Aligned.sortedByCoord.out,chr14,20392343,20400515,+,13,1,14,known,chr14:20392343-20400515
sample_4_Aligned.sortedByCoord.out,chr13,22000190,22009413,-,11,1,12,known,chr13:22000190-22009413
sample_4_Aligned.sortedByCoord.out,chr15,38798973,38799239,-,13,0,13,known,chr15:38798973-38799239
sample_4_Aligned.sortedByCoord.out,chr10,6919751,6929426,-,8,1,9,known,chr10:6919751-6929426
sample_4_Aligned.sortedByCoord.out,chr4,12962288,12966496,+,12,3,15,novel,chr4:12962288-12966496
sample_4_Aligned.sortedByCoord.out,chr19,43583266,43588621,-,8,2,10,known,chr19:43583266-43588621
sample_4_Aligned.sortedByCoord.out,chr7,29427542,29430372,+,16,3,19,known,chr7:29427542-29430372
sample_4_Aligned.sortedByCoord.out,chr2,23782104,23787178,-,10,2,12,known,chr2:23782104-23787178
sample_4_Aligned.sortedByCoord.out,chr22,38038976,38044575,+,17,4,21,novel,chr22:38038976-38044575
sample_4_Aligned.sortedByCoord.out,chr8,24711172,24718915,-,12,1,13,known,chr8:24711172-24718915
sample_4_Aligned.sortedByCoord.out,chr6,3011989,3016696,-,12,4,16,known,chr6:3011989-3016696
sample_4_Aligned.sortedByCoord.out,chr1,9427816,9437519,+,11,0,11,known,chr1:9427816-9437519
sample_4_Aligned.sortedByCoord.out,chr12,6543665,6549976,-,10,1,11,known,chr12:6543665-6549976
sample_4_Aligned.sortedByCoord.out,chr13,36533956,36540822,-,10,3,13,known,chr13:36533956-36540822
sample_4_Aligned.sortedByCoord.out,chr9,48062718,48067230,+,6,0,6,known,chr9:48062718-48067230
sample_4_Aligned.sortedByCoord.out,chr11,25825430,25833540,-,7,1,8,known,chr11:25825430-25833540
sample_4_Aligned.sortedByCoord.out,chr13,24645283,24654419,-,7,3,10,known,chr13:24645283-24654419
sample_4_Aligned.sortedByCoord.out,chr17,24887106,24895892,+,4,1,5,known,chr17:24887106-24895892
sample_4_Aligned.sortedByCoord.out,chr6,24305456,24310860,-,7,2,9,novel,chr6:24305456-24310860
sample_4_Aligned.sortedByCoord.out,chr1,40406262,40414383,-,11,3,14,known,chr1:40406262-40414383
sample_4_Aligned.sortedByCoord.out,chr22,21696706,21703039,+,13,2,15,known,chr22:21696706-21703039
sample_4_Aligned.sortedByCoord.out,chr21,40538438,40540369,-,6,2,8,novel,chr21:40538438-40540369
sample_4_Aligned.sortedByCoord.out,chr22,31775253,31780388,-,12,1,13,known,chr22:31775253-31780388
sample_4_Aligned.sortedByCoord.out,chr11,26446429,26452334,+,14,1,15,known,chr11:26446429-26452334
sample_4_Aligned.sortedByCoord.out,chr4,19062409,19066951,+,7,2,9,known,chr4:19062409-19066951
sample_4_Aligned.sortedByCoord.out,chr8,17293469,17296918,-,8,2,10,known,chr8:17293469-17296918
sample_4_Aligned.sortedByCoord.out,chr3,6612989,6615583,-,7,3,10,known,chr3:6612989-6615583
sample_4_Aligned.sortedByCoord.out,chr22,46619021,46626490,+,13,3,16,known,chr22:46619021-46626490
sample_4_Aligned.sortedByCoord.out,chr15,34796275,34806047,+,5,1,6,known,chr15:34796275-34806047
sample_4_Aligned.sortedByCoord.out,chr18,40899488,40900980,+,15,0,15,known,chr18:40899488-40900980
sample_4_Aligned.sortedByCoord.out,chr21,10241264,10246034,-,5,0,5,known,chr21:10241264-10246034
sample_4_Aligned.sortedByCoord.out,chr13,29936494,29945480,-,9,2,11,novel,chr13:29936494-29945480
sample_4_Aligned.sortedByCoord.out,chr16,23920362,23924595,-,7,3,10,known,chr16:23920362-23924595
sample_4_Aligned.sortedByCoord.out,chr12,10240269,10245574,+,14,2,16,known,chr12:10240269-10245574
sample_4_Aligned.sortedByCoord.out,chr16,13982050,13982993,-,9,1,10,known,chr16:13982050-13982993
sample_4_Aligned.sortedByCoord.out,chr16,38200939,38208756,+,14,2,16,novel,chr16:38200939-38208756
sample_4_Aligned.sortedByCoord.out,chr4,19291801,19297191,-,5,0,5,known,chr4:19291801-19297191
sample_4_Aligned.sortedByCoord.out,chr22,22697740,22707707,-,10,0,10,known,chr22:22697740-22707707
sample_4_Aligned.sortedByCoord.out,chr11,2361838,2363401,+,14,1,15,novel,chr11:2361838-2363401
sample_4_Aligned.sortedByCoord.out,chr22,47736776,47744825,+,14,1,15,known,chr22:47736776-47744825
sample_4_Aligned.sortedByCoord.out,chr20,33520510,33522974,-,12,3,15,known,chr20:33520510-33522974
sample_4_Aligned.sortedByCoord.out,chr22,2536111,2544877,-,13,4,17,known,chr22:2536111-2544877
sample_4_Aligned.sortedByCoord.out,chr19,43395284,43404586,+,15,2,17,known,chr19:43395284-43404586
sample_4_Aligned.sortedByCoord.out,chr7,40541115,40544344,-,10,0,10,known,chr7:40541115-40544344
sample_4_Aligned.sortedByCoord.out,chr18,8050029,8057165,+,9,1,10,novel,chr18:8050029-8057165
sample_4_Aligned.sortedByCoord.out,chr14,20885483,20889835,-,12,3,15,novel,chr14:20885483-20889835
sample_4_Aligned.sortedByCoord.out,chr7,48044001,48045321,-,14,1,15,novel,chr7:48044001-48045321
sample_4_Aligned.sortedByCoord.out,chr16,24208976,24212418,+,11,2,13,novel,chr16:24208976-24212418
sample_4_Aligned.sortedByCoord.out,chr10,12707308,12708110,-,9,2,11,known,chr10:12707308-12708110
sample_4_Aligned.sortedByCoord.out,chr12,24742951,24746635,-,8,2,10,known,chr12:24742951-24746635
sample_4_Aligned.sortedByCoord.out,chr5,3362278,3369985,-,12,4,16,known,chr5:3362278-3369985
sample_4_Aligned.sortedByCoord.out,chr11,20764067,20765109,+,14,2,16,novel,chr11:20764067-20765109
sample_4_Aligned.sortedByCoord.out,chr9,24563859,24572605,-,10,2,12,known,chr9:24563859-24572605
sample_4_Aligned.sortedByCoord.out,chr12,9758729,9764681,-,5,0,5,known,chr12:9758729-9764681
sample_4_Aligned.sortedByCoord.out,chr6,40424916,40427982,-,10,4,14,known,chr6:40424916-40427982
sample_4_Aligned.sortedByCoord.out,chr7,36250560,36255331,-,13,1,14,known,chr7:36250560-36255331
sample_4_Aligned.sortedByCoord.out,chr10,1103273,1107422,+,9,5,14,novel,chr10:1103273-1107422
sample_4_Aligned.sortedByCoord.out,chr7,13365188,13370154,+,11,4,15,novel,chr7:13365188-13370154
sample_4_Aligned.sortedByCoord.out,chr5,43376224,43378501,+,9,2,11,known,chr5:43376224-43378501
sample_4_Aligned.sortedByCoord.out,chr2,34821095,34824793,-,6,3,9,known,chr2:34821095-34824793
sample_4_Aligned.sortedByCoord.out,chr7,45569571,45575984,-,13,1,14,known,chr7:45569571-45575984
sample_4_Aligned.sortedByCoord.out,chr21,1913277,1915673,-,7,0,7,known,chr21:1913277-1915673
sample_4_Aligned.sortedByCoord.out,chr1,23160286,23164379,-,9,3,12,known,chr1:23160286-23164379
sample_4_Aligned.sortedByCoord.out,chr2,40849403,40855530,-,10,4,14,known,chr2:40849403-40855530
sample_4_Aligned.sortedByCoord.out,chr7,39487516,39494684,+,15,5,20,known,chr7:39487516-39494684
sample_4_Aligned.sortedByCoord.out,chr1,38882163,38883032,+,11,5,16,novel,chr1:38882163-38883032
sample_4_Aligned.sortedByCoord.out,chr9,25922012,25928946,-,15,1,16,known,chr9:25922012-25928946
sample_4_Aligned.sortedByCoord.out,chr19,1832123,1836368,-,12,5,17,known,chr19:1832123-1836368
sample_4_Aligned.sortedByCoord.out,chr12,17699207,17699847,-,8,1,9,known,chr12:17699207-17699847
sample_4_Aligned.sortedByCoord.out,chr21,10307486,10311492,-,8,0,8,known,chr21:10307486-10311492
sample_4_Aligned.sortedByCoord.out,chr13,41288014,41291699,+,6,4,10,known,chr13:41288014-41291699
sample_4_Aligned.sortedByCoord.out,chr5,6715946,6717203,-,15,0,15,known,chr5:6715946-6717203
sample_4_Aligned.sortedByCoord.out,chr11,1312794,1317866,-,12,2,14,known,chr11:1312794-1317866
sample_4_Aligned.sortedByCoord.out,chr18,17000012,17006884,+,13,1,14,known,chr18:17000012-17006884
sample_4_Aligned.sortedByCoord.out,chr6,26762810,26764551,+,12,1,13,novel,chr6:26762810-26764551
sample_4_Aligned.sortedByCoord.out,chr5,7580350,7581970,+,5,2,7,known,chr5:7580350-7581970
sample_4_Aligned.sortedByCoord.out,chr13,34893727,34897100,-,13,1,14,known,chr13:34893727-34897100
sample_4_Aligned.sortedByCoord.out,chr3,37533420,37536695,+,6,2,8,known,chr3:37533420-37536695
sample_4_Aligned.sortedByCoord.out,chr15,39218238,39223479,-,14,3,17,known,chr15:39218238-39223479
sample_4_Aligned.sortedByCoord.out,chr17,9012350,9019354,-,16,3,19,known,chr17:9012350-9019354
sample_4_Aligned.sortedByCoord.out,chr14,31632206,31636714,-,9,1,10,known,chr14:31632206-31636714
sample_4_Aligned.sortedByCoord.out,chr16,20499550,20505041,+,13,2,15,novel,chr16:20499550-20505041
sample_4_Aligned.sortedByCoord.out,chr4,42895704,42901844,-,8,2,10,known,chr4:42895704-42901844
sample_4_Aligned.sortedByCoord.out,chr16,17720672,17724237,+,8,0,8,known,chr16:17720672-17724237
sample_4_Aligned.sortedByCoord.out,chr16,28863384,28864936,-,9,4,13,known,chr16:28863384-28864936
sample_4_Aligned.sortedByCoord.out,chr3,30314586,30322970,+,10,2,12,known,chr3:30314586-30322970
sample_4_Aligned.sortedByCoord.out,chr10,11749246,11752931,+,9,1,10,known,chr10:11749246-11752931
sample_4_Aligned.sortedByCoord.out,chr10,6984292,6986968,-,8,1,9,known,chr10:6984292-6986968
sample_4_Aligned.sortedByCoord.out,chr21,4850158,4851907,+,9,2,11,known,chr21:4850158-4851907
sample_4_Aligned.sortedByCoord.out,chr2,39589334,39589720,-,10,3,13,known,chr2:39589334-39589720
sample_4_Aligned.sortedByCoord.out,chr3,29822528,29824624,+,7,4,11,known,chr3:29822528-29824624
sample_4_Aligned.sortedByCoord.out,chr7,27400149,27404906,+,8,0,8,known,chr7:27400149-27404906
sample_4_Aligned.sortedByCoord.out,chr6,34504250,34505066,-,3,5,8,known,chr6:34504250-34505066
sample_4_Aligned.sortedByCoord.out,chr13,26157173,26164498,+,12,1,13,known,chr13:26157173-26164498
sample_4_Aligned.sortedByCoord.out,chr18,36116716,36122417,-,9,1,10,known,chr18:36116716-36122417
sample_4_Aligned.sortedByCoord.out,chr19,36170546,36170997,-,12,1,13,known,chr19:36170546-36170997
sample_4_Aligned.sortedByCoord.out,chr2,18603068,18611124,-,3,2,5,known,chr2:18603068-18611124
sample_4_Aligned.sortedByCoord.out,chr7,1442609,1444786,-,10,1,11,known,chr7:1442609-1444786
sample_4_Aligned.sortedByCoord.out,chr2,15481744,15485831,-,9,1,10,novel,chr2:15481744-15485831
sample_4_Aligned.sortedByCoord.out,chr11,7829711,7831254,+,9,4,13,known,chr11:7829711-7831254
sample_4_Aligned.sortedByCoord.out,chr20,32019313,32023742,+,13,3,16,known,chr20:32019313-32023742
sample_4_Aligned.sortedByCoord.out,chr22,43705902,43712007,+,15,1,16,novel,chr22:43705902-43712007
sample_4_Aligned.sortedByCoord.out,chr21,12234796,12240822,-,9,3,12,known,chr21:12234796-12240822
sample_4_Aligned.sortedByCoord.out,chr1,21670638,21679778,-,9,4,13,known,chr1:21670638-21679778
sample_4_Aligned.sortedByCoord.out,chr13,10052693,10060073,+,11,1,12,known,chr13:10052693-10060073
sample_4_Aligned.sortedByCoord.out,chr7,41062352,41065983,-,5,1,6,known,chr7:41062352-41065983
sample_4_Aligned.sortedByCoord.out,chr21,20265560,20273430,-,10,2,12,novel,chr21:20265560-20273430
sample_4_Aligned.sortedByCoord.out,chr21,26736721,26741988,+,10,2,12,novel,chr21:26736721-26741988
sample_4_Aligned.sortedByCoord.out,chr5,28364279,28371019,+,13,2,15,known,chr5:28364279-28371019
sample_4_Aligned.sortedByCoord.out,chr16,34447861,34453036,+,6,1,7,known,chr16:34447861-34453036
sample_4_Aligned.sortedByCoord.out,chr15,7053463,7058863,+,10,2,12,known,chr15:7053463-7058863
sample_4_Aligned.sortedByCoord.out,chr16,25965887,25972949,-,6,2,8,novel,chr16:25965887-25972949
sample_4_Aligned.sortedByCoord.out,chr7,20200501,20206184,-,10,3,13,known,chr7:20200501-20206184
sample_4_Aligned.sortedByCoord.out,chr1,40707144,40711394,+,10,0,10,known,chr1:40707144-40711394
sample_4_Aligned.sortedByCoord.out,chr12,30768128,30770473,+,7,4,11,known,chr12:30768128-30770473
sample_4_Aligned.sortedByCoord.out,chr3,27465599,27472541,+,9,3,12,known,chr3:27465599-27472541
sample_4_Aligned.sortedByCoord.out,chr20,47263977,47264399,+,10,3,13,known,chr20:47263977-47264399
sample_4_Aligned.sortedByCoord.out,chr15,26611064,26619741,-,13,2,15,known,chr15:26611064-26619741
sample_4_Aligned.sortedByCoord.out,chr20,24499484,24501064,+,12,3,15,novel,chr20:24499484-24501064
sample_4_Aligned.sortedByCoord.out,chr22,4423213,4428698,-,14,3,17,novel,chr22:4423213-4428698
sample_4_Aligned.sortedByCoord.out,chr1,41561379,41561732,-,7,4,11,known,chr1:41561379-41561732
sample_4_Aligned.sortedByCoord.out,chr6,9505184,9510584,-,14,2,16,known,chr6:9505184-9510584
sample_4_Aligned.sortedByCoord.out,chr13,22123748,22131388,+,7,0,7,known,chr13:22123748-22131388
sample_4_Aligned.sortedByCoord.out,chr5,6401743,6410142,+,10,0,10,novel,chr5:6401743-6410142
sample_4_Aligned.sortedByCoord.out,chr11,13495818,13504174,+,12,4,16,known,chr11:13495818-13504174
sample_4_Aligned.sortedByCoord.out,chr21,18922577,18927622,+,9,1,10,known,chr21:18922577-18927622
sample_4_Aligned.sortedByCoord.out,chr18,5751776,5758824,+,11,3,14,known,chr18:5751776-5758824
sample_4_Aligned.sortedByCoord.out,chr2,29941838,29951764,+,5,4,9,known,chr2:29941838-29951764
sample_4_Aligned.sortedByCoord.out,chr2,30529958,30533879,-,5,3,8,known,chr2:30529958-30533879
sample_4_Aligned.sortedByCoord.out,chr1,38115017,38124547,+,12,1,13,novel,chr1:38115017-38124547
sample_4_Aligned.sortedByCoord.out,chr2,45256295,45259379,+,10,3,13,known,chr2:45256295-45259379
sample_4_Aligned.sortedByCoord.out,chr15,13989245,13989633,+,10,2,12,known,chr15:13989245-13989633
sample_4_Aligned.sortedByCoord.out,chr5,31287808,31290093,-,11,1,12,known,chr5:31287808-31290093
sample_4_Aligned.sortedByCoord.out,chr14,23338756,23341341,+,9,2,11,known,chr14:23338756-23341341
sample_4_Aligned.sortedByCoord.out,chr6,14583884,14585568,+,6,4,10,known,chr6:14583884-14585568
sample_4_Aligned.sortedByCoord.out,chr2,22885333,22890083,-,11,0,11,known,chr2:22885333-22890083
sample_4_Aligned.sortedByCoord.out,chr22,27466238,27468142,+,11,3,14,known,chr22:27466238-27468142
sample_4_Aligned.sortedByCoord.out,chr20,9820376,9822200,-,14,4,18,known,chr20:9820376-9822200
sample_4_Aligned.sortedByCoord.out,chr1,35831364,35840142,-,5,5,10,known,chr1:35831364-35840142
sample_4_Aligned.sortedByCoord.out,chr9,40529972,40536666,-,8,2,10,known,chr9:40529972-40536666
sample_4_Aligned.sortedByCoord.out,chr6,31227133,31232930,-,9,2,11,known,chr6:31227133-31232930
sample_4_Aligned.sortedByCoord.out,chr21,34658646,34664179,-,9,5,14,known,chr21:34658646-34664179
sample_4_Aligned.sortedByCoord.out,chr10,31139963,31147255,-,9,1,10,known,chr10:31139963-31147255
sample_4_Aligned.sortedByCoord.out,chr19,1628401,1631528,-,5,4,9,novel,chr19:1628401-1631528
sample_4_Aligned.sortedByCoord.out,chr12,14712632,14716694,-,14,4,18,known,chr12:14712632-14716694
sample_4_Aligned.sortedByCoord.out,chr3,41714933,41718438,+,9,1,10,known,chr3:41714933-41718438
sample_4_Aligned.sortedByCoord.out,chr3,33362368,33368023,-,9,0,9,known,chr3:33362368-33368023
sample_4_Aligned.sortedByCoord.out,chr3,38090898,38092564,-,13,2,15,known,chr3:38090898-38092564
sample_4_Aligned.sortedByCoord.out,chr10,27186448,27191331,-,4,2,6,known,chr10:27186448-27191331
sample_4_Aligned.sortedByCoord.out,chr20,15443799,15447232,+,9,3,12,known,chr20:15443799-15447232
sample_4_Aligned.sortedByCoord.out,chr1,21563859,21568152,+,8,6,14,novel,chr1:21563859-21568152
sample_4_Aligned.sortedByCoord.out,chr9,2364958,2374394,+,10,7,17,known,chr9:2364958-2374394
sample_4_Aligned.sortedByCoord.out,chr10,40061199,40069892,+,11,3,14,known,chr10:40061199-40069892
sample_4_Aligned.sortedByCoord.out,chr1,33691141,33700013,+,10,3,13,known,chr1:33691141-33700013
sample_4_Aligned.sortedByCoord.out,chr20,9086490,9094458,-,14,1,15,known,chr20:9086490-9094458
sample_4_Aligned.sortedByCoord.out,chr10,4333742,4335361,-,10,4,14,known,chr10:4333742-4335361
sample_4_Aligned.sortedByCoord.out,chr22,7968258,7973867,-,10,4,14,known,chr22:7968258-7973867
sample_4_Aligned.sortedByCoord.out,chr14,36583114,36585134,+,15,1,16,novel,chr14:36583114-36585134
sample_4_Aligned.sortedByCoord.out,chr11,37566045,37573755,-,14,1,15,known,chr11:37566045-37573755
sample_4_Aligned.sortedByCoord.out,chr17,25619539,25623071,-,12,1,13,known,chr17:25619539-25623071
sample_4_Aligned.sortedByCoord.out,chr15,29303449,29307715,-,5,2,7,known,chr15:29303449-29307715
sample_4_Aligned.sortedByCoord.out,chr21,34370077,34377189,+,9,2,11,known,chr21:34370077-34377189
sample_4_Aligned.sortedByCoord.out,chr16,1555339,1560717,-,15,3,18,known,chr16:1555339-1560717
sample_4_Aligned.sortedByCoord.out,chr16,17012362,17019222,-,12,0,12,novel,chr16:17012362-17019222
sample_4_Aligned.sortedByCoord.out,chr22,17413009,17417781,+,10,3,13,known,chr22:17413009-17417781
sample_4_Aligned.sortedByCoord.out,chr7,43972657,43975211,+,10,1,11,known,chr7:43972657-43975211
sample_4_Aligned.sortedByCoord.out,chr5,29819422,29826240,-,10,1,11,known,chr5:29819422-29826240
sample_4_Aligned.sortedByCoord.out,chr7,38005719,38006972,+,11,3,14,known,chr7:38005719-38006972
sample_4_Aligned.sortedByCoord.out,chr19,23134969,23143019,-,7,2,9,known,chr19:23134969-23143019
sample_4_Aligned.sortedByCoord.out,chr17,32666141,32670468,-,9,3,12,known,chr17:32666141-32670468
sample_4_Aligned.sortedByCoord.out,chr3,41142181,41146504,-,8,0,8,novel,chr3:41142181-41146504
sample_4_Aligned.sortedByCoord.out,chr11,26819640,26822371,+,11,0,11,known,chr11:26819640-26822371
sample_4_Aligned.sortedByCoord.out,chr9,3228091,3234139,+,9,4,13,known,chr9:3228091-3234139
sample_4_Aligned.sortedByCoord.out,chr13,34198011,34207679,+,11,3,14,known,chr13:34198011-34207679
sample_4_Aligned.sortedByCoord.out,chr20,44373175,44382868,+,8,3,11,known,chr20:44373175-44382868
sample_4_Aligned.sortedByCoord.out,chr5,10993364,10999999,-,11,3,14,known,chr5:10993364-10999999
sample_4_Aligned.sortedByCoord.out,chr19,37792497,37802138,+,9,1,10,known,chr19:37792497-37802138
sample_4_Aligned.sortedByCoord.out,chr5,11053699,11063346,+,11,0,11,known,chr5:11053699-11063346
sample_4_Aligned.sortedByCoord.out,chr13,16553581,16561780,-,10,2,12,novel,chr13:16553581-16561780
sample_4_Aligned.sortedByCoord.out,chr18,47881975,47884176,+,12,3,15,known,chr18:47881975-47884176
sample_4_Aligned.sortedByCoord.out,chr7,33496544,33505145,+,5,1,6,known,chr7:33496544-33505145
sample_4_Aligned.sortedByCoord.out,chr19,40528637,40534245,-,4,2,6,known,chr19:40528637-40534245
sample_4_Aligned.sortedByCoord.out,chr8,21227411,21229362,+,5,0,5,known,chr8:21227411-21229362
sample_4_Aligned.sortedByCoord.out,chr8,12618001,12624751,+,8,1,9,known,chr8:12618001-12624751
sample_4_Aligned.sortedByCoord.out,chr19,34927221,34930198,+,10,1,11,known,chr19:34927221-34930198
sample_4_Aligned.sortedByCoord.out,chr15,16323136,16331179,+,8,3,11,known,chr15:16323136-16331179
sample_4_Aligned.sortedByCoord.out,chr22,35901813,35904088,+,12,2,14,novel,chr22:35901813-35904088
sample_4_Aligned.sortedByCoord.out,chr14,14501854,14505612,-,7,2,9,novel,chr14:14501854-14505612
sample_4_Aligned.sortedByCoord.out,chr1,43943650,43944527,-,8,1,9,known,chr1:43943650-43944527
sample_4_Aligned.sortedByCoord.out,chr10,15939917,15945169,-,11,3,14,novel,chr10:15939917-15945169
sample_4_Aligned.sortedByCoord.out,chr15,28530260,28538520,-,11,2,13,novel,chr15:28530260-28538520
sample_4_Aligned.sortedByCoord.out,chr4,37884209,37889959,-,13,3,16,known,chr4:37884209-37889959
sample_4_Aligned.sortedByCoord.out,chr8,10745500,10750210,+,15,0,15,known,chr8:10745500-10750210
sample_4_Aligned.sortedByCoord.out,chr6,14404774,14412184,+,12,1,13,known,chr6:14404774-14412184
sample_4_Aligned.sortedByCoord.out,chr13,41172026,41181469,-,13,1,14,known,chr13:41172026-41181469
sample_4_Aligned.sortedByCoord.out,chr19,28693512,28698136,-,7,2,9,known,chr19:28693512-28698136
sample_4_Aligned.sortedByCoord.out,chr3,41587797,41590867,+,12,2,14,novel,chr3:41587797-41590867
sample_4_Aligned.sortedByCoord.out,chr1,34001936,34005437,-,8,2,10,known,chr1:34001936-34005437
sample_4_Aligned.sortedByCoord.out,chr22,20710938,20720286,-,13,0,13,known,chr22:20710938-20720286
sample_4_Aligned.sortedByCoord.out,chr11,18455115,18462568,-,4,7,11,known,chr11:18455115-18462568
sample_4_Aligned.sortedByCoord.out,chr17,17427019,17427221,+,8,3,11,known,chr17:17427019-17427221
sample_4_Aligned.sortedByCoord.out,chr12,23750107,23754776,+,5,3,8,known,chr12:23750107-23754776
sample_4_Aligned.sortedByCoord.out,chr4,49571258,49580421,+,16,0,16,known,chr4:49571258-49580421
sample_4_Aligned.sortedByCoord.out,chr13,6595478,6602774,+,11,6,17,known,chr13:6595478-6602774
sample_4_Aligned.sortedByCoord.out,chr20,27144609,27148194,-,11,4,15,novel,chr20:27144609-27148194
sample_4_Aligned.sortedByCoord.out,chr10,16747457,16756220,-,9,5,14,known,chr10:16747457-16756220
sample_4_Aligned.sortedByCoord.out,chr11,27610747,27618083,+,12,2,14,known,chr11:27610747-27618083
sample_4_Aligned.sortedByCoord.out,chr13,11843221,11846077,+,3,1,4,known,chr13:11843221-11846077
sample_4_Aligned.sortedByCoord.out,chr16,3371692,3376159,+,13,1,14,known,chr16:3371692-3376159
sample_4_Aligned.sortedByCoord.out,chr20,4099878,4109062,-,10,1,11,known,chr20:4099878-4109062
sample_4_Aligned.sortedByCoord.out,chr22,7017585,7025935,+,8,6,14,known,chr22:7017585-7025935
sample_4_Aligned.sortedByCoord.out,chr2,10447421,10457002,+,9,1,10,known,chr2:10447421-10457002
sample_4_Aligned.sortedByCoord.out,chr12,28895506,28902826,+,9,0,9,novel,chr12:28895506-28902826
sample_4_Aligned.sortedByCoord.out,chr21,11661434,11665886,+,15,1,16,known,chr21:11661434-11665886
sample_4_Aligned.sortedByCoord.out,chr11,20997226,20997388,+,9,1,10,known,chr11:20997226-20997388
sample_4_Aligned.sortedByCoord.out,chr10,18615286,18623463,+,9,4,13,known,chr10:18615286-18623463
sample_4_Aligned.sortedByCoord.out,chr2,41097089,41101484,+,13,3,16,novel,chr2:41097089-41101484
sample_4_Aligned.sortedByCoord.out,chr21,22622878,22628975,+,7,2,9,novel,chr21:22622878-22628975
sample_4_Aligned.sortedByCoord.out,chr1,11339993,11348998,-,12,0,12,novel,chr1:11339993-11348998
sample_4_Aligned.sortedByCoord.out,chr7,39930345,39934968,-,16,0,16,known,chr7:39930345-39934968
sample_4_Aligned.sortedByCoord.out,chr18,49299987,49304581,+,10,3,13,novel,chr18:49299987-49304581
sample_4_Aligned.sortedByCoord.out,chr1,46073829,46075587,-,10,1,11,novel,chr1:46073829-46075587
sample_4_Aligned.sortedByCoord.out,chr5,41540498,41543657,+,8,0,8,known,chr5:41540498-41543657
sample_4_Aligned.sortedByCoord.out,chr22,36017263,36017627,-,11,0,11,known,chr22:36017263-36017627
sample_4_Aligned.sortedByCoord.out,chr7,35864822,35865764,+,7,2,9,known,chr7:35864822-35865764
sample_4_Aligned.sortedByCoord.out,chr9,33700705,33704300,+,6,0,6,known,chr9:33700705-33704300
sample_4_Aligned.sortedByCoord.out,chr4,28984628,28990089,-,10,1,11,known,chr4:28984628-28990089
sample_4_Aligned.sortedByCoord.out,chr16,45931696,45932391,+,11,0,11,known,chr16:45931696-45932391
sample_4_Aligned.sortedByCoord.out,chr2,8161329,8171086,-,8,1,9,known,chr2:8161329-8171086
sample_4_Aligned.sortedByCoord.out,chr12,38206222,38206366,+,10,1,11,known,chr12:38206222-38206366
sample_4_Aligned.sortedByCoord.out,chr20,44181144,44188415,-,11,4,15,known,chr20:44181144-44188415
sample_4_Aligned.sortedByCoord.out,chr12,5388380,5398108,+,12,3,15,known,chr12:5388380-5398108
sample_4_Aligned.sortedByCoord.out,chr2,22518014,22520941,-,15,0,15,known,chr2:22518014-22520941
sample_4_Aligned.sortedByCoord.out,chr16,3397671,3406685,-,5,1,6,novel,chr16:3397671-3406685
sample_4_Aligned.sortedByCoord.out,chr4,19181207,19185570,+,9,4,13,novel,chr4:19181207-19185570
sample_4_Aligned.sortedByCoord.out,chr4,46001152,46010748,+,13,1,14,known,chr4:46001152-46010748
sample_4_Aligned.sortedByCoord.out,chr3,41560819,41565727,-,6,2,8,known,chr3:41560819-41565727
sample_4_Aligned.sortedByCoord.out,chr12,20020068,20023509,+,13,0,13,novel,chr12:20020068-20023509
sample_4_Aligned.sortedByCoord.out,chr6,24081851,24088752,+,10,2,12,known,chr6:24081851-24088752
sample_4_Aligned.sortedByCoord.out,chr12,8258528,8260827,-,4,1,5,known,chr12:8258528-8260827
sample_4_Aligned.sortedByCoord.out,chr2,48678703,48685232,+,9,1,10,known,chr2:48678703-48685232
sample_4_Aligned.sortedByCoord.out,chr20,37377399,37379233,-,12,4,16,known,chr20:37377399-37379233
sample_4_Aligned.sortedByCoord.out,chr20,25986430,25994799,+,10,0,10,known,chr20:25986430-25994799
sample_4_Aligned.sortedByCoord.out,chr6,31682094,31687600,-,14,1,15,known,chr6:31682094-31687600
sample_4_Aligned.sortedByCoord.out,chr21,21796104,21800391,-,14,4,18,known,chr21:21796104-21800391
sample_4_Aligned.sortedByCoord.out,chr21,13181765,13185695,+,14,2,16,known,chr21:13181765-13185695
sample_4_Aligned.sortedByCoord.out,chr19,13335069,13344603,+,8,2,10,known,chr19:13335069-13344603
sample_4_Aligned.sortedByCoord.out,chr13,48387897,48390010,-,10,1,11,known,chr13:48387897-48390010
sample_4_Aligned.sortedByCoord.out,chr17,3964508,3965863,-,12,1,13,known,chr17:3964508-3965863
sample_4_Aligned.sortedByCoord.out,chr12,43298079,43299518,+,18,1,19,known,chr12:43298079-43299518
sample_4_Aligned.sortedByCoord.out,chr13,9586444,9593676,-,6,1,7,known,chr13:9586444-9593676
sample_4_Aligned.sortedByCoord.out,chr12,39325312,39332750,-,14,2,16,novel,chr12:39325312-39332750
sample_4_Aligned.sortedByCoord.out,chr19,7176285,7177350,-,10,3,13,novel,chr19:7176285-7177350
sample_4_Aligned.sortedByCoord.out,chr21,49247384,49249627,+,14,1,15,novel,chr21:49247384-49249627
sample_4_Aligned.sortedByCoord.out,chr12,25705621,25706584,-,10,3,13,known,chr12:25705621-25706584
sample_4_Aligned.sortedByCoord.out,chr13,25475540,25482498,-,10,2,12,novel,chr13:25475540-25482498
sample_4_Aligned.sortedByCoord.out,chr6,30152587,30156523,-,12,1,13,known,chr6:30152587-30156523
sample_4_Aligned.sortedByCoord.out,chr8,8104945,8106780,+,9,0,9,known,chr8:8104945-8106780
sample_4_Aligned.sortedByCoord.out,chr19,31143090,31143262,-,4,1,5,known,chr19:31143090-31143262
sample_4_Aligned.sortedByCoord.out,chr15,13798531,13804440,-,14,1,15,known,chr15:13798531-13804440
sample_4_Aligned.sortedByCoord.out,chr11,41441396,41449174,+,16,3,19,known,chr11:41441396-41449174
sample_4_Aligned.sortedByCoord.out,chr19,28979177,28988410,+,7,2,9,novel,chr19:28979177-28988410
sample_4_Aligned.sortedByCoord.out,chr20,8302447,8309157,-,2,2,4,novel,chr20:8302447-8309157
sample_4_Aligned.sortedByCoord.out,chr19,48705147,48713922,+,12,1,13,known,chr19:48705147-48713922
sample_4_Aligned.sortedByCoord.out,chr4,43431860,43438032,-,10,1,11,known,chr4:43431860-43438032
sample_4_Aligned.sortedByCoord.out,chr18,8175954,8176477,+,10,3,13,known,chr18:8175954-8176477
sample_4_Aligned.sortedByCoord.out,chr22,13977215,13985075,-,8,2,10,novel,chr22:13977215-13985075
sample_4_Aligned.sortedByCoord.out,chr20,17004311,17004857,+,10,4,14,known,chr20:17004311-17004857
sample_4_Aligned.sortedByCoord.out,chr22,28947462,28952031,-,11,1,12,known,chr22:28947462-28952031
sample_4_Aligned.sortedByCoord.out,chr17,37570245,37572964,+,12,4,16,known,chr17:37570245-37572964
sample_4_Aligned.sortedByCoord.out,chr11,40011717,40016867,-,8,1,9,known,chr11:40011717-40016867
sample_4_Aligned.sortedByCoord.out,chr9,1019207,1027678,-,5,4,9,known,chr9:1019207-1027678
sample_4_Aligned.sortedByCoord.out,chr10,22318491,22321806,-,13,0,13,known,chr10:22318491-22321806
sample_4_Aligned.sortedByCoord.out,chr3,40013026,40013221,+,10,1,11,novel,chr3:40013026-40013221
sample_4_Aligned.sortedByCoord.out,chr14,9748882,9751648,-,10,0,10,known,chr14:9748882-9751648
sample_4_Aligned.sortedByCoord.out,chr17,47056972,47059093,-,5,0,5,known,chr17:47056972-47059093
sample_4_Aligned.sortedByCoord.out,chr4,32211082,32211748,+,9,1,10,known,chr4:32211082-32211748
sample_4_Aligned.sortedByCoord.out,chr14,33288527,33293900,-,16,4,20,novel,chr14:33288527-33293900
sample_4_Aligned.sortedByCoord.out,chr1,19452793,19458578,-,7,2,9,known,chr1:19452793-19458578
sample_4_Aligned.sortedByCoord.out,chr18,39969230,39979133,-,13,0,13,known,chr18:39969230-39979133
sample_4_Aligned.sortedByCoord.out,chr17,29499505,29507494,-,10,3,13,known,chr17:29499505-29507494
sample_4_Aligned.sortedByCoord.out,chr5,42075187,42082315,+,7,1,8,known,chr5:42075187-42082315
sample_4_Aligned.sortedByCoord.out,chr22,28682526,28689879,-,13,1,14,known,chr22:28682526-28689879
sample_4_Aligned.sortedByCoord.out,chr1,35877267,35879331,-,9,1,10,known,chr1:35877267-35879331
sample_4_Aligned.sortedByCoord.out,chr1,10701769,10711324,-,6,4,10,known,chr1:10701769-10711324
sample_4_Aligned.sortedByCoord.out,chr10,32362968,32365330,+,8,0,8,known,chr10:32362968-32365330
sample_4_Aligned.sortedByCoord.out,chr13,15616700,15623647,+,12,0,12,known,chr13:15616700-15623647
sample_4_Aligned.sortedByCoord.out,chr22,30862720,30869617,-,10,3,13,novel,chr22:30862720-30869617
sample_4_Aligned.sortedByCoord.out,chr5,24039692,24041536,-,8,0,8,novel,chr5:24039692-24041536
sample_4_Aligned.sortedByCoord.out,chr2,37745870,37753512,-,8,2,10,known,chr2:37745870-37753512
sample_4_Aligned.sortedByCoord.out,chr22,10268958,10269791,+,7,0,7,known,chr22:10268958-10269791
sample_4_Aligned.sortedByCoord.out,chr12,44441693,44451013,-,7,0,7,novel,chr12:44441693-44451013
sample_4_Aligned.sortedByCoord.out,chr16,45217391,45224162,+,12,1,13,novel,chr16:45217391-45224162
sample_4_Aligned.sortedByCoord.out,chr12,36020968,36030123,+,9,1,10,known,chr12:36020968-36030123
sample_4_Aligned.sortedByCoord.out,chr17,40996746,41001310,+,11,1,12,known,chr17:40996746-41001310
sample_4_Aligned.sortedByCoord.out,chr7,43657519,43658165,+,17,3,20,known,chr7:43657519-43658165
sample_4_Aligned.sortedByCoord.out,chr10,9053075,9057725,+,11,0,11,known,chr10:9053075-9057725
sample_4_Aligned.sortedByCoord.out,chr17,46664581,46671344,+,6,3,9,novel,chr17:46664581-46671344
sample_4_Aligned.sortedByCoord.out,chr7,21659174,21668766,-,12,4,16,known,chr7:21659174-21668766
sample_4_Aligned.sortedByCoord.out,chr7,3267611,3273825,+,11,0,11,known,chr7:3267611-3273825
sample_4_Aligned.sortedByCoord.out,chr14,9025422,9030122,+,8,2,10,known,chr14:9025422-9030122
sample_4_Aligned.sortedByCoord.out,chr1,24948076,24950905,+,12,2,14,known,chr1:24948076-24950905
sample_4_Aligned.sortedByCoord.out,chr11,13437357,13445119,-,8,2,10,novel,chr11:13437357-13445119
sample_4_Aligned.sortedByCoord.out,chr22,37230982,37235438,+,8,2,10,known,chr22:37230982-37235438
sample_4_Aligned.sortedByCoord.out,chr10,48541153,48543937,+,7,1,8,known,chr10:48541153-48543937
sample_4_Aligned.sortedByCoord.out,chr1,19613420,19616360,+,10,2,12,known,chr1:19613420-19616360
sample_4_Aligned.sortedByCoord.out,chr22,9041907,9047367,+,15,2,17,known,chr22:9041907-9047367
sample_4_Aligned.sortedByCoord.out,chr6,42267119,42267418,-,16,3,19,known,chr6:42267119-42267418
sample_4_Aligned.sortedByCoord.out,chr3,31077122,31078060,+,13,2,15,known,chr3:31077122-31078060
sample_4_Aligned.sortedByCoord.out,chr18,3319122,3324771,+,18,2,20,known,chr18:3319122-3324771
sample_4_Aligned.sortedByCoord.out,chr16,47810201,47811472,-,11,4,15,known,chr16:47810201-47811472
sample_4_Aligned.sortedByCoord.out,chr13,15572206,15579309,+,6,4,10,known,chr13:15572206-15579309
sample_4_Aligned.sortedByCoord.out,chr14,28965503,28970866,-,8,0,8,novel,chr14:28965503-28970866
sample_4_Aligned.sortedByCoord.out,chr11,17011249,17013959,-,13,3,16,known,chr11:17011249-17013959
sample_4_Aligned.sortedByCoord.out,chr20,15607049,15608681,-,14,3,17,known,chr20:15607049-15608681
sample_4_Aligned.sortedByCoord.out,chr16,10516609,10525890,-,8,4,12,novel,chr16:10516609-10525890
sample_4_Aligned.sortedByCoord.out,chr7,13572829,13577610,+,4,2,6,known,chr7:13572829-13577610
sample_4_Aligned.sortedByCoord.out,chr3,38619609,38621620,+,14,2,16,known,chr3:38619609-38621620
sample_4_Aligned.sortedByCoord.out,chr9,34317082,34324571,-,7,0,7,known,chr9:34317082-34324571
sample_4_Aligned.sortedByCoord.out,chr1,4996380,4996595,+,8,4,12,known,chr1:4996380-4996595
sample_4_Aligned.sortedByCoord.out,chr16,36247545,36256383,+,10,2,12,known,chr16:36247545-36256383
sample_4_Aligned.sortedByCoord.out,chr1,9436437,9443214,-,10,2,12,novel,chr1:9436437-9443214
sample_4_Aligned.sortedByCoord.out,chr10,31341316,31343632,+,8,2,10,novel,chr10:31341316-31343632
sample_4_Aligned.sortedByCoord.out,chr1,39494732,39501609,-,9,2,11,novel,chr1:39494732-39501609
sample_4_Aligned.sortedByCoord.out,chr4,20061749,20069345,+,10,1,11,known,chr4:20061749-20069345
sample_4_Aligned.sortedByCoord.out,chr19,23377395,23382139,+,15,4,19,known,chr19:23377395-23382139
sample_4_Aligned.sortedByCoord.out,chr12,8425072,8428867,-,7,3,10,known,chr12:8425072-8428867
sample_4_Aligned.sortedByCoord.out,chr9,9595183,9603221,-,8,1,9,novel,chr9:9595183-9603221
sample_4_Aligned.sortedByCoord.out,chr18,15274484,15282924,-,17,2,19,known,chr18:15274484-15282924
sample_4_Aligned.sortedByCoord.out,chr16,5156626,5160890,-,11,3,14,known,chr16:5156626-5160890
sample_4_Aligned.sortedByCoord.out,chr6,3480444,3487887,-,8,5,13,known,chr6:3480444-3487887
sample_4_Aligned.sortedByCoord.out,chr10,22270579,22276411,+,13,1,14,known,chr10:22270579-22276411
sample_4_Aligned.sortedByCoord.out,chr13,17392101,17392385,-,10,3,13,known,chr13:17392101-17392385
sample_4_Aligned.sortedByCoord.out,chr8,18834104,18834984,+,8,2,10,known,chr8:18834104-18834984
sample_4_Aligned.sortedByCoord.out,chr3,10935134,10941776,+,9,2,11,novel,chr3:10935134-10941776
sample_4_Aligned.sortedByCoord.out,chr14,44213683,44214185,-,9,4,13,known,chr14:44213683-44214185
sample_4_Aligned.sortedByCoord.out,chr10,4800830,4807239,+,4,1,5,novel,chr10:4800830-4807239
sample_4_Aligned.sortedByCoord.out,chr19,34448161,34456173,-,13,1,14,novel,chr19:34448161-34456173
sample_4_Aligned.sortedByCoord.out,chr16,8551580,8559809,-,9,1,10,known,chr16:8551580-8559809
sample_4_Aligned.sortedByCoord.out,chr9,46833354,46840437,-,9,4,13,known,chr9:46833354-46840437
sample_4_Aligned.sortedByCoord.out,chr3,38041332,38044573,+,12,3,15,novel,chr3:38041332-38044573
sample_4_Aligned.sortedByCoord.out,chr9,43179107,43185133,-,9,0,9,known,chr9:43179107-43185133
sample_4_Aligned.sortedByCoord.out,chr9,12377176,12383136,+,9,3,12,known,chr9:12377176-12383136
sample_4_Aligned.sortedByCoord.out,chr16,49389465,49389570,+,8,2,10,novel,chr16:49389465-49389570
sample_4_Aligned.sortedByCoord.out,chr2,30151380,30158082,+,6,3,9,known,chr2:30151380-30158082
sample_4_Aligned.sortedByCoord.out,chr11,49320707,49323773,-,6,2,8,known,chr11:49320707-49323773
sample_4_Aligned.sortedByCoord.out,chr17,32571102,32578251,-,11,2,13,novel,chr17:32571102-32578251
sample_4_Aligned.sortedByCoord.out,chr1,43355581,43357267,-,10,1,11,known,chr1:43355581-43357267
sample_4_Aligned.sortedByCoord.out,chr2,31227327,31231787,+,9,1,10,known,chr2:31227327-31231787
sample_4_Aligned.sortedByCoord.out,chr7,48641047,48644053,-,9,1,10,known,chr7:48641047-48644053
sample_4_Aligned.sortedByCoord.out,chr16,43825709,43833331,+,4,1,5,known,chr16:43825709-43833331
sample_4_Aligned.sortedByCoord.out,chr21,29334738,29343416,+,8,4,12,known,chr21:29334738-29343416
sample_4_Aligned.sortedByCoord.out,chr22,21346755,21349137,+,10,1,11,known,chr22:21346755-21349137
sample_4_Aligned.sortedByCoord.out,chr19,32979328,32983271,+,9,3,12,novel,chr19:32979328-32983271
sample_4_Aligned.sortedByCoord.out,chr13,11343435,11346497,+,11,3,14,novel,chr13:11343435-11346497
sample_4_Aligned.sortedByCoord.out,chr18,36567755,36568057,+,6,2,8,known,chr18:36567755-36568057
sample_4_Aligned.sortedByCoord.out,chr2,41883508,41884570,-,14,3,17,novel,chr2:41883508-41884570
sample_4_Aligned.sortedByCoord.out,chr16,15818819,15819035,+,9,4,13,known,chr16:15818819-15819035
sample_4_Aligned.sortedByCoord.out,chr18,5065644,5069532,-,11,2,13,novel,chr18:5065644-5069532
sample_4_Aligned.sortedByCoord.out,chr5,36556047,36557796,+,9,2,11,novel,chr5:36556047-36557796
sample_4_Aligned.sortedByCoord.out,chr16,47297549,47307443,+,8,1,9,known,chr16:47297549-47307443
sample_4_Aligned.sortedByCoord.out,chr13,49294942,49301290,-,9,3,12,known,chr13:49294942-49301290
sample_4_Aligned.sortedByCoord.out,chr10,26707338,26714646,-,9,1,10,known,chr10:26707338-26714646
sample_4_Aligned.sortedByCoord.out,chr15,18913590,18918813,-,15,1,16,known,chr15:18913590-18918813
sample_4_Aligned.sortedByCoord.out,chr1,14945023,14954997,+,8,0,8,known,chr1:14945023-14954997
sample_4_Aligned.sortedByCoord.out,chr15,2119537,2121304,+,11,1,12,known,chr15:2119537-2121304
sample_4_Aligned.sortedByCoord.out,chr21,35011929,35016835,-,9,2,11,known,chr21:35011929-35016835
sample_4_Aligned.sortedByCoord.out,chr18,18433728,18440044,+,11,2,13,known,chr18:18433728-18440044
sample_4_Aligned.sortedByCoord.out,chr8,6211852,6215528,-,12,1,13,known,chr8:6211852-6215528
sample_4_Aligned.sortedByCoord.out,chr16,45580686,45588545,+,11,0,11,novel,chr16:45580686-45588545
sample_4_Aligned.sortedByCoord.out,chr22,18069336,18074399,+,17,1,18,known,chr22:18069336-18074399
sample_4_Aligned.sortedByCoord.out,chr14,12581885,12584103,-,6,2,8,novel,chr14:12581885-12584103
sample_4_Aligned.sortedByCoord.out,chr20,18112417,18119232,-,9,1,10,known,chr20:18112417-18119232
sample_4_Aligned.sortedByCoord.out,chr15,47777399,47784384,-,8,4,12,novel,chr15:47777399-47784384
sample_4_Aligned.sortedByCoord.out,chr21,45070165,45070518,+,6,7,13,known,chr21:45070165-45070518
sample_4_Aligned.sortedByCoord.out,chr22,17429845,17435048,-,13,4,17,known,chr22:17429845-17435048
sample_4_Aligned.sortedByCoord.out,chr5,42127460,42136252,-,14,2,16,known,chr5:42127460-42136252
sample_4_Aligned.sortedByCoord.out,chr21,21115831,21122916,-,16,3,19,novel,chr21:21115831-21122916
sample_4_Aligned.sortedByCoord.out,chr10,27226056,27228567,-,9,3,12,known,chr10:27226056-27228567
sample_4_Aligned.sortedByCoord.out,chr1,3646017,3654015,+,8,2,10,known,chr1:3646017-3654015
sample_4_Aligned.sortedByCoord.out,chr13,1357228,1360949,+,9,1,10,known,chr13:1357228-1360949
sample_4_Aligned.sortedByCoord.out,chr20,39257916,39260539,+,12,4,16,known,chr20:39257916-39260539
sample_4_Aligned.sortedByCoord.out,chr21,17348711,17352277,+,8,3,11,known,chr21:17348711-17352277
sample_4_Aligned.sortedByCoord.out,chr7,37632238,37639742,-,7,0,7,novel,chr7:37632238-37639742
sample_4_Aligned.sortedByCoord.out,chr3,34457377,34466030,+,9,1,10,known,chr3:34457377-34466030
sample_4_Aligned.sortedByCoord.out,chr20,23476906,23481716,-,10,0,10,novel,chr20:23476906-23481716
sample_4_Aligned.sortedByCoord.out,chr10,21400087,21400317,+,8,2,10,known,chr10:21400087-21400317
sample_4_Aligned.sortedByCoord.out,chr18,44597054,44601417,+,7,2,9,known,chr18:44597054-44601417
sample_4_Aligned.sortedByCoord.out,chr15,19017104,19021324,-,9,3,12,known,chr15:19017104-19021324
sample_4_Aligned.sortedByCoord.out,chr20,40374209,40376973,+,11,1,12,known,chr20:40374209-40376973
sample_4_Aligned.sortedByCoord.out,chr11,11007073,11010174,-,10,1,11,known,chr11:11007073-11010174
sample_4_Aligned.sortedByCoord.out,chr19,20191474,20198370,+,6,4,10,known,chr19:20191474-20198370
sample_4_Aligned.sortedByCoord.out,chr10,29628983,29634742,+,11,3,14,novel,chr10:29628983-29634742
sample_4_Aligned.sortedByCoord.out,chr1,23882462,23884725,-,9,0,9,known,chr1:23882462-23884725
sample_4_Aligned.sortedByCoord.out,chr17,22792408,22792867,+,10,2,12,known,chr17:22792408-22792867
sample_4_Aligned.sortedByCoord.out,chr6,9472120,9477009,-,15,1,16,novel,chr6:9472120-9477009
sample_4_Aligned.sortedByCoord.out,chr2,34139509,34140200,+,6,2,8,known,chr2:34139509-34140200
sample_4_Aligned.sortedByCoord.out,chr8,24151049,24155802,-,12,3,15,known,chr8:24151049-24155802
sample_4_Aligned.sortedByCoord.out,chr6,23457620,23465663,+,10,2,12,known,chr6:23457620-23465663
sample_4_Aligned.sortedByCoord.out,chr9,28001935,28010695,-,9,1,10,known,chr9:28001935-28010695
sample_4_Aligned.sortedByCoord.out,chr16,21888967,21894236,-,10,2,12,known,chr16:21888967-21894236
sample_4_Aligned.sortedByCoord.out,chr1,38863994,38870220,+,8,0,8,novel,chr1:38863994-38870220
sample_4_Aligned.sortedByCoord.out,chr8,41554275,41563738,+,8,3,11,known,chr8:41554275-41563738
sample_4_Aligned.sortedByCoord.out,chr3,36755044,36759905,-,6,3,9,known,chr3:36755044-36759905
sample_4_Aligned.sortedByCoord.out,chr1,41102269,41102665,-,5,5,10,known,chr1:41102269-41102665
sample_4_Aligned.sortedByCoord.out,chr20,47119033,47126195,+,7,1,8,known,chr20:47119033-47126195
sample_4_Aligned.sortedByCoord.out,chr2,1178988,1179269,+,13,1,14,known,chr2:1178988-1179269
sample_4_Aligned.sortedByCoord.out,chr10,25011548,25021043,-,7,0,7,novel,chr10:25011548-25021043
sample_4_Aligned.sortedByCoord.out,chr5,1539262,1544578,-,12,0,12,novel,chr5:1539262-1544578
sample_4_Aligned.sortedByCoord.out,chr8,25250316,25259239,+,7,1,8,known,chr8:25250316-25259239
sample_4_Aligned.sortedByCoord.out,chr7,39745828,39750093,+,5,0,5,known,chr7:39745828-39750093
sample_4_Aligned.sortedByCoord.out,chr18,15282748,15290347,+,10,3,13,novel,chr18:15282748-15290347
sample_4_Aligned.sortedByCoord.out,chr5,48643952,48644465,-,9,2,11,known,chr5:48643952-48644465
sample_4_Aligned.sortedByCoord.out,chr9,28411351,28419016,-,8,3,11,known,chr9:28411351-28419016
sample_4_Aligned.sortedByCoord.out,chr2,32773376,32777465,-,10,2,12,known,chr2:32773376-32777465
sample_4_Aligned.sortedByCoord.out,chr5,17573549,17582218,-,9,3,12,novel,chr5:17573549-17582218
sample_4_Aligned.sortedByCoord.out,chr3,9265126,9272922,+,6,2,8,known,chr3:9265126-9272922
sample_4_Aligned.sortedByCoord.out,chr6,48685814,48694210,+,6,3,9,known,chr6:48685814-48694210
sample_4_Aligned.sortedByCoord.out,chr9,28491132,28498500,+,8,0,8,known,chr9:28491132-28498500
sample_4_Aligned.sortedByCoord.out,chr20,23686312,23692074,+,11,2,13,known,chr20:23686312-23692074
sample_4_Aligned.sortedByCoord.out,chr8,30608018,30610332,+,7,5,12,novel,chr8:30608018-30610332
sample_4_Aligned.sortedByCoord.out,chr1,38874411,38881594,+,7,0,7,known,chr1:38874411-38881594
sample_4_Aligned.sortedByCoord.out,chr2,44196436,44202449,-,10,5,15,known,chr2:44196436-44202449
sample_4_Aligned.sortedByCoord.out,chr20,13003686,13006875,+,8,3,11,novel,chr20:13003686-13006875
sample_4_Aligned.sortedByCoord.out,chr4,49030608,49037150,-,7,2,9,known,chr4:49030608-49037150
sample_4_Aligned.sortedByCoord.out,chr1,37152193,37153140,-,11,3,14,known,chr1:37152193-37153140
sample_4_Aligned.sortedByCoord.out,chr17,26303786,26308393,+,8,3,11,known,chr17:26303786-26308393
sample_4_Aligned.sortedByCoord.out,chr9,34434303,34436491,-,7,0,7,known,chr9:34434303-34436491
sample_4_Aligned.sortedByCoord.out,chr3,27554122,27559593,+,9,0,9,known,chr3:27554122-27559593
sample_4_Aligned.sortedByCoord.out,chr12,35295805,35302220,+,6,1,7,known,chr12:35295805-35302220
sample_4_Aligned.sortedByCoord.out,chr12,47822312,47831335,-,10,3,13,known,chr12:47822312-47831335
sample_4_Aligned.sortedByCoord.out,chr1,22387841,22395352,+,12,1,13,known,chr1:22387841-22395352
sample_4_Aligned.sortedByCoord.out,chr18,42341517,42347791,-,11,1,12,novel,chr18:42341517-42347791
sample_4_Aligned.sortedByCoord.out,chr2,9438507,9443658,+,6,1,7,known,chr2:9438507-9443658
sample_4_Aligned.sortedByCoord.out,chr22,47258245,47258378,-,9,2,11,novel,chr22:47258245-47258378
sample_4_Aligned.sortedByCoord.out,chr10,32998608,33000059,+,6,3,9,known,chr10:32998608-33000059
sample_4_Aligned.sortedByCoord.out,chr2,25850957,25856482,+,9,5,14,known,chr2:25850957-25856482
sample_4_Aligned.sortedByCoord.out,chr8,25567072,25569114,-,14,2,16,known,chr8:25567072-25569114
sample_4_Aligned.sortedByCoord.out,chr17,4896163,4901495,-,16,1,17,known,chr17:4896163-4901495
sample_4_Aligned.sortedByCoord.out,chr5,48312933,48321685,-,9,3,12,known,chr5:48312933-48321685
sample_4_Aligned.sortedByCoord.out,chr17,6770147,6780031,-,11,2,13,known,chr17:6770147-6780031
sample_4_Aligned.sortedByCoord.out,chr6,21600510,21610355,+,17,1,18,novel,chr6:21600510-21610355
sample_4_Aligned.sortedByCoord.out,chr4,45903995,45904448,-,9,2,11,known,chr4:45903995-45904448
sample_4_Aligned.sortedByCoord.out,chr8,37436030,37440744,-,10,1,11,novel,chr8:37436030-37440744
sample_4_Aligned.sortedByCoord.out,chr10,38476733,38486378,+,11,1,12,known,chr10:38476733-38486378
sample_4_Aligned.sortedByCoord.out,chr18,45251752,45251888,-,14,0,14,novel,chr18:45251752-45251888
sample_4_Aligned.sortedByCoord.out,chr18,35293136,35303100,-,16,1,17,known,chr18:35293136-35303100
sample_4_Aligned.sortedByCoord.out,chr8,7460691,7463356,-,7,2,9,known,chr8:7460691-7463356
sample_4_Aligned.sortedByCoord.out,chr13,23522266,23526502,-,13,4,17,known,chr13:23522266-23526502
sample_4_Aligned.sortedByCoord.out,chr6,11756685,11765138,-,16,4,20,novel,chr6:11756685-11765138
sample_4_Aligned.sortedByCoord.out,chr14,40603247,40611327,+,9,2,11,novel,chr14:40603247-40611327
sample_4_Aligned.sortedByCoord.out,chr11,26087746,26093674,+,13,0,13,known,chr11:26087746-26093674
sample_4_Aligned.sortedByCoord.out,chr3,46632497,46641099,+,6,3,9,known,chr3:46632497-46641099
sample_4_Aligned.sortedByCoord.out,chr14,4058759,4066325,+,15,4,19,novel,chr14:4058759-4066325
sample_4_Aligned.sortedByCoord.out,chr16,41672416,41676752,-,13,3,16,known,chr16:41672416-41676752
sample_4_Aligned.sortedByCoord.out,chr12,31335276,31336974,+,11,6,17,known,chr12:31335276-31336974
sample_4_Aligned.sortedByCoord.out,chr4,14639705,14641007,+,9,1,10,known,chr4:14639705-14641007
sample_4_Aligned.sortedByCoord.out,chr6,15125381,15130835,-,13,2,15,known,chr6:15125381-15130835
sample_4_Aligned.sortedByCoord.out,chr7,14028740,14034572,+,9,2,11,known,chr7:14028740-14034572
sample_4_Aligned.sortedByCoord.out,chr14,11548590,11553855,+,8,3,11,known,chr14:11548590-11553855
sample_4_Aligned.sortedByCoord.out,chr22,48060035,48069599,+,10,4,14,known,chr22:48060035-48069599
sample_4_Aligned.sortedByCoord.out,chr17,11435454,11436176,-,16,2,18,known,chr17:11435454-11436176
sample_4_Aligned.sortedByCoord.out,chr6,32623454,32624905,-,13,4,17,known,chr6:32623454-32624905
sample_4_Aligned.sortedByCoord.out,chr17,45955312,45960469,-,14,2,16,known,chr17:45955312-45960469
sample_4_Aligned.sortedByCoord.out,chr7,7556538,7558671,+,11,0,11,known,chr7:7556538-7558671
sample_4_Aligned.sortedByCoord.out,chr16,24408649,24409100,-,5,2,7,novel,chr16:24408649-24409100
sample_4_Aligned.sortedByCoord.out,chr12,47589691,47597128,-,9,0,9,known,chr12:47589691-47597128
sample_4_Aligned.sortedByCoord.out,chr1,27533574,27533901,+,9,2,11,known,chr1:27533574-27533901
sample_4_Aligned.sortedByCoord.out,chr18,31720410,31727134,+,14,0,14,novel,chr18:31720410-31727134
sample_4_Aligned.sortedByCoord.out,chr12,33990838,33996826,-,13,0,13,known,chr12:33990838-33996826
sample_4_Aligned.sortedByCoord.out,chr19,23789705,23799243,-,12,2,14,known,chr19:23789705-23799243
sample_4_Aligned.sortedByCoord.out,chr1,29230260,29232994,+,7,1,8,known,chr1:29230260-29232994
sample_4_Aligned.sortedByCoord.out,chr8,17382082,17385702,-,12,1,13,known,chr8:17382082-17385702
sample_4_Aligned.sortedByCoord.out,chr2,17156287,17161457,-,9,1,10,novel,chr2:17156287-17161457
sample_4_Aligned.sortedByCoord.out,chr11,11146830,11155154,-,11,2,13,novel,chr11:11146830-11155154
sample_4_Aligned.sortedByCoord.out,chr1,7825335,7831444,+,17,2,19,known,chr1:7825335-7831444
sample_4_Aligned.sortedByCoord.out,chr3,6325558,6332871,+,7,1,8,novel,chr3:6325558-6332871
sample_4_Aligned.sortedByCoord.out,chr4,18609555,18613799,-,12,3,15,novel,chr4:18609555-18613799
sample_4_Aligned.sortedByCoord.out,chr19,33166878,33169744,-,9,1,10,known,chr19:33166878-33169744
sample_4_Aligned.sortedByCoord.out,chr7,16982189,16985883,+,6,2,8,known,chr7:16982189-16985883
sample_4_Aligned.sortedByCoord.out,chr7,21914323,21917039,+,12,3,15,known,chr7:21914323-21917039
sample_4_Aligned.sortedByCoord.out,chr21,48734827,48738279,+,5,1,6,novel,chr21:48734827-48738279
sample_4_Aligned.sortedByCoord.out,chr1,1273307,1275302,-,12,1,13,known,chr1:1273307-1275302
sample_4_Aligned.sortedByCoord.out,chr6,6247011,6256762,+,7,3,10,known,chr6:6247011-6256762
sample_4_Aligned.sortedByCoord.out,chr20,11656988,11661487,-,12,1,13,known,chr20:11656988-11661487
sample_4_Aligned.sortedByCoord.out,chr13,16482029,16483955,+,15,3,18,known,chr13:16482029-16483955
sample_4_Aligned.sortedByCoord.out,chr13,39333396,39340725,+,13,2,15,known,chr13:39333396-39340725
sample_4_Aligned.sortedByCoord.out,chr15,38249983,38253619,-,12,2,14,known,chr15:38249983-38253619
sample_4_Aligned.sortedByCoord.out,chr19,17049404,17056838,+,11,2,13,known,chr19:17049404-17056838
sample_4_Aligned.sortedByCoord.out,chr20,38026580,38035665,-,11,3,14,known,chr20:38026580-38035665
sample_4_Aligned.sortedByCoord.out,chr20,19900624,19901395,+,14,0,14,known,chr20:19900624-19901395
sample_4_Aligned.sortedByCoord.out,chr16,47816120,47825772,+,8,4,12,known,chr16:47816120-47825772
sample_4_Aligned.sortedByCoord.out,chr21,41735927,41745427,+,10,1,11,known,chr21:41735927-41745427
sample_4_Aligned.sortedByCoord.out,chr15,14020516,14029973,+,10,3,13,known,chr15:14020516-14029973
sample_4_Aligned.sortedByCoord.out,chr16,47640369,47646760,+,10,2,12,known,chr16:47640369-47646760
sample_4_Aligned.sortedByCoord.out,chr7,27653691,27654075,+,11,4,15,known,chr7:27653691-27654075
sample_4_Aligned.sortedByCoord.out,chr6,11348275,11356992,-,13,4,17,known,chr6:11348275-11356992
sample_4_Aligned.sortedByCoord.out,chr1,2140276,2142211,-,14,3,17,known,chr1:2140276-2142211
sample_4_Aligned.sortedByCoord.out,chr12,12520799,12522563,+,13,1,14,known,chr12:12520799-12522563
sample_4_Aligned.sortedByCoord.out,chr2,45717418,45719339,-,13,1,14,novel,chr2:45717418-45719339
sample_4_Aligned.sortedByCoord.out,chr22,4280707,4285073,+,10,3,13,known,chr22:4280707-4285073
sample_4_Aligned.sortedByCoord.out,chr16,23665902,23671010,+,10,1,11,known,chr16:23665902-23671010
sample_4_Aligned.sortedByCoord.out,chr19,19169311,19170115,-,5,2,7,known,chr19:19169311-19170115
sample_4_Aligned.sortedByCoord.out,chr10,34373125,34380842,-,8,1,9,known,chr10:34373125-34380842
sample_4_Aligned.sortedByCoord.out,chr4,7666536,7671250,-,10,3,13,known,chr4:7666536-7671250
sample_4_Aligned.sortedByCoord.out,chr15,38913832,38914850,-,8,1,9,known,chr15:38913832-38914850
sample_4_Aligned.sortedByCoord.out,chr17,2698226,2700571,+,17,1,18,known,chr17:2698226-2700571
sample_4_Aligned.sortedByCoord.out,chr9,14516338,14526010,-,16,1,17,known,chr9:14516338-14526010
sample_4_Aligned.sortedByCoord.out,chr19,48759392,48768045,-,9,1,10,known,chr19:48759392-48768045
sample_4_Aligned.sortedByCoord.out,chr3,43643695,43650397,+,4,2,6,known,chr3:43643695-43650397
sample_4_Aligned.sortedByCoord.out,chr19,22789222,22793009,+,12,2,14,known,chr19:22789222-22793009
sample_4_Aligned.sortedByCoord.out,chr20,1307862,1312350,-,14,0,14,known,chr20:1307862-1312350
sample_4_Aligned.sortedByCoord.out,chr2,5556956,5561668,+,7,3,10,known,chr2:5556956-5561668
sample_4_Aligned.sortedByCoord.out,chr17,27012721,27014983,+,9,2,11,known,chr17:27012721-27014983
sample_4_Aligned.sortedByCoord.out,chr14,10712929,10720899,-,14,2,16,novel,chr14:10712929-10720899
sample_4_Aligned.sortedByCoord.out,chr8,45480770,45483261,-,13,1,14,known,chr8:45480770-45483261
sample_4_Aligned.sortedByCoord.out,chr10,46350941,46357354,+,7,2,9,known,chr10:46350941-46357354
sample_4_Aligned.sortedByCoord.out,chr9,45328351,45338250,-,12,1,13,novel,chr9:45328351-45338250
sample_4_Aligned.sortedByCoord.out,chr13,24500586,24502433,-,13,1,14,known,chr13:24500586-24502433
sample_4_Aligned.sortedByCoord.out,chr18,35673571,35681547,+,9,5,14,known,chr18:35673571-35681547
sample_4_Aligned.sortedByCoord.out,chr10,25348363,25351723,-,8,1,9,known,chr10:25348363-25351723
sample_4_Aligned.sortedByCoord.out,chr8,9006095,9008268,-,10,1,11,known,chr8:9006095-9008268
sample_4_Aligned.sortedByCoord.out,chr21,43592153,43601517,+,12,5,17,known,chr21:43592153-43601517
sample_4_Aligned.sortedByCoord.out,chr21,18470490,18479518,-,8,1,9,known,chr21:18470490-18479518
sample_4_Aligned.sortedByCoord.out,chr15,21765293,21769814,-,12,4,16,known,chr15:21765293-21769814
sample_4_Aligned.sortedByCoord.out,chr20,23929895,23937905,-,7,0,7,known,chr20:23929895-23937905
sample_4_Aligned.sortedByCoord.out,chr18,4784417,4788397,+,11,3,14,known,chr18:4784417-4788397
sample_4_Aligned.sortedByCoord.out,chr18,15230080,15232458,+,6,0,6,known,chr18:15230080-15232458
sample_4_Aligned.sortedByCoord.out,chr17,11084326,11092421,-,5,1,6,known,chr17:11084326-11092421
sample_4_Aligned.sortedByCoord.out,chr6,5270711,5276038,-,6,1,7,known,chr6:5270711-5276038
sample_4_Aligned.sortedByCoord.out,chr14,4566360,4567225,-,10,3,13,known,chr14:4566360-4567225
sample_4_Aligned.sortedByCoord.out,chr17,3799068,3805633,-,13,1,14,novel,chr17:3799068-3805633
sample_4_Aligned.sortedByCoord.out,chr9,49363324,49368207,+,15,2,17,known,chr9:49363324-49368207
sample_4_Aligned.sortedByCoord.out,chr9,23085447,23090898,-,8,2,10,known,chr9:23085447-23090898
sample_4_Aligned.sortedByCoord.out,chr9,46779658,46784755,+,8,2,10,known,chr9:46779658-46784755
sample_4_Aligned.sortedByCoord.out,chr13,37408266,37408667,-,9,6,15,known,chr13:37408266-37408667
sample_4_Aligned.sortedByCoord.out,chr6,38251499,38254940,+,9,1,10,known,chr6:38251499-38254940
sample_4_Aligned.sortedByCoord.out,chr2,27352883,27362839,+,9,2,11,known,chr2:27352883-27362839
sample_4_Aligned.sortedByCoord.out,chr1,6557812,6559670,+,12,2,14,known,chr1:6557812-6559670
sample_4_Aligned.sortedByCoord.out,chr2,41947931,41954671,+,11,0,11,known,chr2:41947931-41954671
sample_4_Aligned.sortedByCoord.out,chr4,36703456,36705895,+,8,1,9,novel,chr4:36703456-36705895
sample_4_Aligned.sortedByCoord.out,chr22,40018922,40026962,+,11,3,14,known,chr22:40018922-40026962
sample_4_Aligned.sortedByCoord.out,chr22,2373822,2381903,+,17,0,17,known,chr22:2373822-2381903
sample_4_Aligned.sortedByCoord.out,chr5,21822271,21824904,+,11,1,12,novel,chr5:21822271-21824904
sample_4_Aligned.sortedByCoord.out,chr4,15172527,15175252,-,10,1,11,novel,chr4:15172527-15175252
sample_4_Aligned.sortedByCoord.out,chr14,31857225,31866209,+,11,5,16,known,chr14:31857225-31866209
sample_4_Aligned.sortedByCoord.out,chr14,1674573,1674836,-,10,1,11,novel,chr14:1674573-1674836
sample_4_Aligned.sortedByCoord.out,chr13,11844927,11851046,+,7,2,9,novel,chr13:11844927-11851046
sample_4_Aligned.sortedByCoord.out,chr7,11657372,11666225,-,6,2,8,known,chr7:11657372-11666225
sample_4_Aligned.sortedByCoord.out,chr5,26059734,26061373,+,8,4,12,known,chr5:26059734-26061373
sample_4_Aligned.sortedByCoord.out,chr13,36341330,36343252,+,10,1,11,known,chr13:36341330-36343252
sample_4_Aligned.sortedByCoord.out,chr19,21928269,21932174,-,22,1,23,known,chr19:21928269-21932174
sample_4_Aligned.sortedByCoord.out,chr11,32839110,32840628,-,10,1,11,known,chr11:32839110-32840628
sample_4_Aligned.sortedByCoord.out,chr17,44155905,44157189,-,9,1,10,known,chr17:44155905-44157189
sample_4_Aligned.sortedByCoord.out,chr7,3589864,3596948,+,9,0,9,known,chr7:3589864-3596948
sample_4_Aligned.sortedByCoord.out,chr2,38761465,38767581,+,9,1,10,novel,chr2:38761465-38767581
sample_4_Aligned.sortedByCoord.out,chr19,4482881,4492332,-,15,2,17,known,chr19:4482881-4492332
sample_4_Aligned.sortedByCoord.out,chr18,18634695,18638384,-,9,2,11,novel,chr18:18634695-18638384
sample_4_Aligned.sortedByCoord.out,chr8,48845938,48847526,-,8,2,10,known,chr8:48845938-48847526
sample_4_Aligned.sortedByCoord.out,chr22,44018446,44019683,-,11,5,16,known,chr22:44018446-44019683
sample_4_Aligned.sortedByCoord.out,chr16,9888374,9896031,+,7,3,10,novel,chr16:9888374-9896031
sample_4_Aligned.sortedByCoord.out,chr18,49041842,49041999,-,10,3,13,known,chr18:49041842-49041999
sample_4_Aligned.sortedByCoord.out,chr5,39791963,39796100,+,9,0,9,known,chr5:39791963-39796100
sample_5_Aligned.sortedByCoord.out,chr2,45769791,45770166,-,10,3,13,known,chr2:45769791-45770166
sample_5_Aligned.sortedByCoord.out,chr15,34045207,34053991,-,10,3,13,known,chr15:34045207-34053991
sample_5_Aligned.sortedByCoord.out,chr17,41178504,41180271,+,12,3,15,known,chr17:41178504-41180271
sample_5_Aligned.sortedByCoord.out,chr4,34238781,34244942,+,10,0,10,novel,chr4:34238781-34244942
sample_5_Aligned.sortedByCoord.out,chr14,9242818,9250233,-,13,1,14,known,chr14:9242818-9250233
sample_5_Aligned.sortedByCoord.out,chr19,42162337,42167522,-,13,1,14,known,chr19:42162337-42167522
sample_5_Aligned.sortedByCoord.out,chr16,7994049,7997424,+,9,3,12,known,chr16:7994049-7997424
sample_5_Aligned.sortedByCoord.out,chr17,19043127,19048292,-,7,5,12,known,chr17:19043127-19048292
sample_5_Aligned.sortedByCoord.out,chr17,5416497,5425013,-,11,4,15,known,chr17:5416497-5425013
sample_5_Aligned.sortedByCoord.out,chr16,10524741,10531586,+,6,1,7,known,chr16:10524741-10531586
sample_5_Aligned.sortedByCoord.out,chr15,49748028,49749427,-,3,3,6,known,chr15:49748028-49749427
sample_5_Aligned.sortedByCoord.out,chr16,27582971,27586011,+,7,2,9,known,chr16:27582971-27586011
sample_5_Aligned.sortedByCoord.out,chr15,40019919,40027243,+,9,1,10,novel,chr15:40019919-40027243
sample_5_Aligned.sortedByCoord.out,chr9,1219847,1225541,-,7,3,10,known,chr9:1219847-1225541
sample_5_Aligned.sortedByCoord.out,chr16,7993891,7996520,+,8,3,11,known,chr16:7993891-7996520
sample_5_Aligned.sortedByCoord.out,chr16,36028822,36029082,-,4,2,6,known,chr16:36028822-36029082
sample_5_Aligned.sortedByCoord.out,chr22,4568864,4574232,+,8,3,11,known,chr22:4568864-4574232
sample_5_Aligned.sortedByCoord.out,chr12,4001986,4003794,-,11,3,14,known,chr12:4001986-4003794
sample_5_Aligned.sortedByCoord.out,chr5,40310602,40312820,+,6,0,6,known,chr5:40310602-40312820
sample_5_Aligned.sortedByCoord.out,chr18,26122202,26129194,-,6,1,7,novel,chr18:26122202-26129194
sample_5_Aligned.sortedByCoord.out,chr20,38726988,38730013,+,6,2,8,novel,chr20:38726988-38730013
sample_5_Aligned.sortedByCoord.out,chr22,24148186,24148664,-,20,3,23,known,chr22:24148186-24148664
sample_5_Aligned.sortedByCoord.out,chr21,27404280,27404931,+,17,2,19,known,chr21:27404280-27404931
sample_5_Aligned.sortedByCoord.out,chr19,18950936,18957165,+,9,2,11,known,chr19:18950936-18957165
sample_5_Aligned.sortedByCoord.out,chr9,12981903,12986187,-,8,0,8,known,chr9:12981903-12986187
sample_5_Aligned.sortedByCoord.out,chr12,42113830,42122232,-,13,1,14,novel,chr12:42113830-42122232
sample_5_Aligned.sortedByCoord.out,chr21,11393033,11394240,-,9,3,12,known,chr21:11393033-11394240
sample_5_Aligned.sortedByCoord.out,chr18,34973575,34980617,-,8,1,9,known,chr18:34973575-34980617
sample_5_Aligned.sortedByCoord.out,chr15,30606241,30609211,+,11,4,15,known,chr15:30606241-30609211
sample_5_Aligned.sortedByCoord.out,chr15,33930921,33933647,-,9,1,10,known,chr15:33930921-33933647
sample_5_Aligned.sortedByCoord.out,chr18,32133531,32137849,-,6,1,7,known,chr18:32133531-32137849
sample_5_Aligned.sortedByCoord.out,chr6,34951626,34960637,-,10,2,12,known,chr6:34951626-34960637
sample_5_Aligned.sortedByCoord.out,chr10,32082202,32084612,-,8,2,10,known,chr10:32082202-32084612
sample_5_Aligned.sortedByCoord.out,chr21,30082190,30083014,+,16,1,17,known,chr21:30082190-30083014
sample_5_Aligned.sortedByCoord.out,chr21,44053889,44060566,+,9,3,12,known,chr21:44053889-44060566
sample_5_Aligned.sortedByCoord.out,chr1,31268990,31278757,-,7,1,8,novel,chr1:31268990-31278757
sample_5_Aligned.sortedByCoord.out,chr19,5742524,5751748,+,10,1,11,known,chr19:5742524-5751748
sample_5_Aligned.sortedByCoord.out,chr2,21657952,21661885,+,10,4,14,known,chr2:21657952-21661885
sample_5_Aligned.sortedByCoord.out,chr9,49101818,49102556,+,13,2,15,novel,chr9:49101818-49102556
sample_5_Aligned.sortedByCoord.out,chr6,33820804,33826681,+,14,4,18,known,chr6:33820804-33826681
sample_5_Aligned.sortedByCoord.out,chr3,33664630,33664921,-,11,1,12,known,chr3:33664630-33664921
sample_5_Aligned.sortedByCoord.out,chr11,49869970,49873181,+,10,1,11,novel,chr11:49869970-49873181
sample_5_Aligned.sortedByCoord.out,chr6,46930046,46934285,-,9,0,9,known,chr6:46930046-46934285
sample_5_Aligned.sortedByCoord.out,chr21,20972311,20979094,-,12,3,15,novel,chr21:20972311-20979094
sample_5_Aligned.sortedByCoord.out,chr14,25939249,25940825,+,11,3,14,known,chr14:25939249-25940825
sample_5_Aligned.sortedByCoord.out,chr21,28256722,28260865,-,15,1,16,known,chr21:28256722-28260865
sample_5_Aligned.sortedByCoord.out,chr1,28016078,28017421,-,8,0,8,known,chr1:28016078-28017421
sample_5_Aligned.sortedByCoord.out,chr21,26752174,26758160,-,14,0,14,novel,chr21:26752174-26758160
sample_5_Aligned.sortedByCoord.out,chr21,31571698,31577004,-,6,3,9,known,chr21:31571698-31577004
sample_5_Aligned.sortedByCoord.out,chr19,30788724,30791430,-,10,5,15,novel,chr19:30788724-30791430
sample_5_Aligned.sortedByCoord.out,chr22,44948062,44955127,+,13,1,14,known,chr22:44948062-44955127
sample_5_Aligned.sortedByCoord.out,chr21,5174194,5183274,-,12,2,14,known,chr21:5174194-5183274
sample_5_Aligned.sortedByCoord.out,chr16,29231775,29234164,-,13,2,15,novel,chr16:29231775-29234164
sample_5_Aligned.sortedByCoord.out,chr19,30033905,30037133,-,9,0,9,known,chr19:30033905-30037133
sample_5_Aligned.sortedByCoord.out,chr18,36456266,36464782,-,12,1,13,known,chr18:36456266-36464782
sample_5_Aligned.sortedByCoord.out,chr7,22881415,22885919,+,6,2,8,known,chr7:22881415-22885919
sample_5_Aligned.sortedByCoord.out,chr20,4515891,4519115,-,8,1,9,novel,chr20:4515891-4519115
sample_5_Aligned.sortedByCoord.out,chr17,30010052,30017484,+,10,4,14,known,chr17:30010052-30017484
sample_5_Aligned.sortedByCoord.out,chr15,42181464,42186768,+,12,2,14,known,chr15:42181464-42186768
sample_5_Aligned.sortedByCoord.out,chr14,38354854,38359073,+,14,4,18,known,chr14:38354854-38359073
sample_5_Aligned.sortedByCoord.out,chr3,12823531,12828480,-,15,1,16,known,chr3:12823531-12828480
sample_5_Aligned.sortedByCoord.out,chr12,42095677,42095903,+,12,2,14,known,chr12:42095677-42095903
sample_5_Aligned.sortedByCoord.out,chr21,49823151,49824730,-,9,0,9,known,chr21:49823151-49824730
sample_5_Aligned.sortedByCoord.out,chr3,38298807,38302566,+,10,4,14,known,chr3:38298807-38302566
sample_5_Aligned.sortedByCoord.out,chr18,20706128,20711000,-,15,1,16,known,chr18:20706128-20711000
sample_5_Aligned.sortedByCoord.out,chr3,27735319,27743134,+,8,4,12,known,chr3:27735319-27743134
sample_5_Aligned.sortedByCoord.out,chr6,20512241,20515306,-,17,4,21,known,chr6:20512241-20515306
sample_5_Aligned.sortedByCoord.out,chr14,6355308,6365161,-,11,0,11,known,chr14:6355308-6365161
sample_5_Aligned.sortedByCoord.out,chr11,11338978,11343800,+,10,1,11,known,chr11:11338978-11343800
sample_5_Aligned.sortedByCoord.out,chr21,22856239,22865232,+,11,3,14,known,chr21:22856239-22865232
sample_5_Aligned.sortedByCoord.out,chr18,22799197,22808909,-,11,0,11,known,chr18:22799197-22808909
sample_5_Aligned.sortedByCoord.out,chr13,4058436,4064123,+,6,4,10,known,chr13:4058436-4064123
sample_5_Aligned.sortedByCoord.out,chr6,41342256,41345491,+,10,1,11,novel,chr6:41342256-41345491
sample_5_Aligned.sortedByCoord.out,chr22,48570340,48577247,+,12,0,12,novel,chr22:48570340-48577247
sample_5_Aligned.sortedByCoord.out,chr19,13409779,13411495,-,7,2,9,known,chr19:13409779-13411495
sample_5_Aligned.sortedByCoord.out,chr12,38629718,38636500,-,10,3,13,known,chr12:38629718-38636500
sample_5_Aligned.sortedByCoord.out,chr12,39803255,39811102,+,13,6,19,known,chr12:39803255-39811102
sample_5_Aligned.sortedByCoord.out,chr2,22915285,22922589,-,8,4,12,novel,chr2:22915285-22922589
sample_5_Aligned.sortedByCoord.out,chr11,22635835,22636110,-,10,3,13,known,chr11:22635835-22636110
sample_5_Aligned.sortedByCoord.out,chr1,4721607,4730725,+,9,2,11,known,chr1:4721607-4730725
sample_5_Aligned.sortedByCoord.out,chr14,31334319,31341941,-,10,2,12,known,chr14:31334319-31341941
sample_5_Aligned.sortedByCoord.out,chr5,47647333,47654647,-,9,3,12,known,chr5:47647333-47654647
sample_5_Aligned.sortedByCoord.out,chr11,7027352,7033107,-,14,2,16,known,chr11:7027352-7033107
sample_5_Aligned.sortedByCoord.out,chr1,39524076,39532022,-,6,0,6,known,chr1:39524076-39532022
sample_5_Aligned.sortedByCoord.out,chr9,23057307,23066645,-,7,1,8,novel,chr9:23057307-23066645
sample_5_Aligned.sortedByCoord.out,chr13,2922002,2926627,-,9,0,9,known,chr13:2922002-2926627
sample_5_Aligned.sortedByCoord.out,chr14,33879110,33885913,-,8,3,11,known,chr14:33879110-33885913
sample_5_Aligned.sortedByCoord.out,chr5,19041263,19044433,+,13,2,15,known,chr5:19041263-19044433
sample_5_Aligned.sortedByCoord.out,chr13,25501014,25507250,+,11,3,14,known,chr13:25501014-25507250
sample_5_Aligned.sortedByCoord.out,chr12,10170371,10174949,-,5,3,8,known,chr12:10170371-10174949
sample_5_Aligned.sortedByCoord.out,chr11,29680046,29685137,+,6,6,12,known,chr11:29680046-29685137
sample_5_Aligned.sortedByCoord.out,chr2,6017576,6026221,-,9,2,11,known,chr2:6017576-6026221
sample_5_Aligned.sortedByCoord.out,chr3,47228805,47234920,+,13,3,16,novel,chr3:47228805-47234920
sample_5_Aligned.sortedByCoord.out,chr21,41014388,41014583,+,8,2,10,known,chr21:41014388-41014583
sample_5_Aligned.sortedByCoord.out,chr19,41249981,41257710,+,11,1,12,novel,chr19:41249981-41257710
sample_5_Aligned.sortedByCoord.out,chr11,48168388,48177203,+,11,3,14,novel,chr11:48168388-48177203
sample_5_Aligned.sortedByCoord.out,chr5,46509639,46513805,+,6,3,9,known,chr5:46509639-46513805
sample_5_Aligned.sortedByCoord.out,chr7,36834516,36837553,+,12,0,12,novel,chr7:36834516-36837553
sample_5_Aligned.sortedByCoord.out,chr13,34657460,34661910,+,13,1,14,known,chr13:34657460-34661910
sample_5_Aligned.sortedByCoord.out,chr17,31991320,31997614,-,9,2,11,known,chr17:31991320-31997614
sample_5_Aligned.sortedByCoord.out,chr12,20858942,20860197,-,8,2,10,novel,chr12:20858942-20860197
sample_5_Aligned.sortedByCoord.out,chr13,8323270,8327031,+,18,2,20,known,chr13:8323270-8327031
sample_5_Aligned.sortedByCoord.out,chr4,39041820,39051367,-,15,1,16,known,chr4:39041820-39051367
sample_5_Aligned.sortedByCoord.out,chr4,6006033,6010657,-,8,3,11,known,chr4:6006033-6010657
sample_5_Aligned.sortedByCoord.out,chr1,18989884,18999680,+,9,1,10,known,chr1:18989884-18999680
sample_5_Aligned.sortedByCoord.out,chr2,37059994,37063969,-,14,0,14,known,chr2:37059994-37063969
sample_5_Aligned.sortedByCoord.out,chr21,32369927,32378087,+,10,3,13,known,chr21:32369927-32378087
sample_5_Aligned.sortedByCoord.out,chr16,28585306,28593868,+,7,1,8,known,chr16:28585306-28593868
sample_5_Aligned.sortedByCoord.out,chr15,31115978,31119447,-,6,2,8,known,chr15:31115978-31119447
sample_5_Aligned.sortedByCoord.out,chr11,44107780,44116661,-,11,3,14,known,chr11:44107780-44116661
sample_5_Aligned.sortedByCoord.out,chr18,31405054,31406743,-,15,1,16,known,chr18:31405054-31406743
sample_5_Aligned.sortedByCoord.out,chr7,43292453,43296388,+,12,2,14,known,chr7:43292453-43296388
sample_5_Aligned.sortedByCoord.out,chr13,5613040,5619759,+,9,2,11,known,chr13:5613040-5619759
sample_5_Aligned.sortedByCoord.out,chr17,39529507,39536272,-,16,2,18,known,chr17:39529507-39536272
sample_5_Aligned.sortedByCoord.out,chr19,28247084,28250212,-,11,2,13,known,chr19:28247084-28250212
sample_5_Aligned.sortedByCoord.out,chr10,31628252,31628500,-,7,1,8,known,chr10:31628252-31628500
sample_5_Aligned.sortedByCoord.out,chr14,46274230,46278833,-,8,1,9,known,chr14:46274230-46278833
sample_5_Aligned.sortedByCoord.out,chr11,18633250,18638444,+,6,6,12,known,chr11:18633250-18638444
sample_5_Aligned.sortedByCoord.out,chr15,32493699,32502678,-,13,4,17,known,chr15:32493699-32502678
sample_5_Aligned.sortedByCoord.out,chr15,43848125,43849349,-,10,1,11,known,chr15:43848125-43849349
sample_5_Aligned.sortedByCoord.out,chr19,17096897,17106393,+,9,1,10,known,chr19:17096897-17106393
sample_5_Aligned.sortedByCoord.out,chr12,27370878,27373886,+,13,2,15,novel,chr12:27370878-27373886
sample_5_Aligned.sortedByCoord.out,chr10,22563426,22563960,-,6,1,7,known,chr10:22563426-22563960
sample_5_Aligned.sortedByCoord.out,chr9,2923828,2928968,-,8,2,10,known,chr9:2923828-2928968
sample_5_Aligned.sortedByCoord.out,chr4,22335302,22340343,-,18,2,20,known,chr4:22335302-22340343
sample_5_Aligned.sortedByCoord.out,chr21,49269992,49277020,-,19,4,23,known,chr21:49269992-49277020
sample_5_Aligned.sortedByCoord.out,chr3,31678042,31685885,-,12,3,15,known,chr3:31678042-31685885
sample_5_Aligned.sortedByCoord.out,chr19,1811420,1812724,+,6,0,6,known,chr19:1811420-1812724
sample_5_Aligned.sortedByCoord.out,chr20,13602646,13612229,+,10,4,14,known,chr20:13602646-13612229
sample_5_Aligned.sortedByCoord.out,chr15,27265410,27271414,+,14,5,19,known,chr15:27265410-27271414
sample_5_Aligned.sortedByCoord.out,chr10,35825577,35834051,-,7,1,8,known,chr10:35825577-35834051
sample_5_Aligned.sortedByCoord.out,chr6,16290318,16296829,-,6,4,10,known,chr6:16290318-16296829
sample_5_Aligned.sortedByCoord.out,chr11,17449975,17459735,-,4,2,6,known,chr11:17449975-17459735
sample_5_Aligned.sortedByCoord.out,chr12,32770473,32778398,+,9,1,10,novel,chr12:32770473-32778398
sample_5_Aligned.sortedByCoord.out,chr12,9867023,9873474,-,12,2,14,known,chr12:9867023-9873474
sample_5_Aligned.sortedByCoord.out,chr5,41043554,41052120,+,14,5,19,novel,chr5:41043554-41052120
sample_5_Aligned.sortedByCoord.out,chr3,16112904,16117947,+,9,2,11,known,chr3:16112904-16117947
sample_5_Aligned.sortedByCoord.out,chr8,16858837,16863375,-,8,2,10,known,chr8:16858837-16863375
sample_5_Aligned.sortedByCoord.out,chr14,26566847,26574449,+,12,4,16,known,chr14:26566847-26574449
sample_5_Aligned.sortedByCoord.out,chr9,18853071,18853777,+,13,1,14,known,chr9:18853071-18853777
sample_5_Aligned.sortedByCoord.out,chr19,41685233,41686903,-,11,3,14,known,chr19:41685233-41686903
sample_5_Aligned.sortedByCoord.out,chr8,39139614,39140446,+,7,2,9,known,chr8:39139614-39140446
sample_5_Aligned.sortedByCoord.out,chr5,11306614,11316424,+,11,2,13,novel,chr5:11306614-11316424
sample_5_Aligned.sortedByCoord.out,chr18,47598914,47604892,-,7,4,11,known,chr18:47598914-47604892
sample_5_Aligned.sortedByCoord.out,chr12,35918779,35924256,-,12,2,14,known,chr12:35918779-35924256
sample_5_Aligned.sortedByCoord.out,chr11,19832518,19833571,+,12,0,12,known,chr11:19832518-19833571
sample_5_Aligned.sortedByCoord.out,chr21,17298506,17307099,-,6,2,8,known,chr21:17298506-17307099
sample_5_Aligned.sortedByCoord.out,chr1,2911464,2912623,+,11,6,17,known,chr1:2911464-2912623
sample_5_Aligned.sortedByCoord.out,chr7,32462270,32466558,-,10,1,11,known,chr7:32462270-32466558
sample_5_Aligned.sortedByCoord.out,chr1,19052575,19057765,+,7,2,9,novel,chr1:19052575-19057765
sample_5_Aligned.sortedByCoord.out,chr11,26998226,27006001,-,8,0,8,known,chr11:26998226-27006001
sample_5_Aligned.sortedByCoord.out,chr15,32244552,32246419,+,19,0,19,known,chr15:32244552-32246419
sample_5_Aligned.sortedByCoord.out,chr2,44187311,44197237,-,7,1,8,known,chr2:44187311-44197237
sample_5_Aligned.sortedByCoord.out,chr19,14719927,14728907,+,9,1,10,novel,chr19:14719927-14728907
sample_5_Aligned.sortedByCoord.out,chr1,36881660,36885435,+,14,4,18,known,chr1:36881660-36885435
sample_5_Aligned.sortedByCoord.out,chr12,15541409,15545277,-,10,1,11,novel,chr12:15541409-15545277
sample_5_Aligned.sortedByCoord.out,chr8,17654830,17658260,+,13,3,16,known,chr8:17654830-17658260
sample_5_Aligned.sortedByCoord.out,chr3,11062127,11064781,-,16,3,19,known,chr3:11062127-11064781
sample_5_Aligned.sortedByCoord.out,chr18,22028720,22031280,+,7,1,8,novel,chr18:22028720-22031280
sample_5_Aligned.sortedByCoord.out,chr11,1694785,1703629,-,10,3,13,known,chr11:1694785-1703629
sample_5_Aligned.sortedByCoord.out,chr21,14962966,14970541,-,12,1,13,known,chr21:14962966-14970541
sample_5_Aligned.sortedByCoord.out,chr14,14853970,14857526,+,12,2,14,novel,chr14:14853970-14857526
sample_5_Aligned.sortedByCoord.out,chr17,23576751,23581540,+,10,1,11,known,chr17:23576751-23581540
sample_5_Aligned.sortedByCoord.out,chr3,26458150,26467032,-,10,1,11,known,chr3:26458150-26467032
sample_5_Aligned.sortedByCoord.out,chr17,13499975,13508112,-,8,0,8,known,chr17:13499975-13508112
sample_5_Aligned.sortedByCoord.out,chr2,21964856,21970949,+,11,4,15,known,chr2:21964856-21970949
sample_5_Aligned.sortedByCoord.out,chr17,29615634,29620300,-,8,1,9,known,chr17:29615634-29620300
sample_5_Aligned.sortedByCoord.out,chr15,7578413,7584505,-,10,0,10,known,chr15:7578413-7584505
sample_5_Aligned.sortedByCoord.out,chr12,25012682,25017362,-,14,3,17,known,chr12:25012682-25017362
sample_5_Aligned.sortedByCoord.out,chr9,26435144,26441984,+,9,2,11,known,chr9:26435144-26441984
sample_5_Aligned.sortedByCoord.out,chr1,48793842,48802355,-,9,2,11,known,chr1:48793842-48802355
sample_5_Aligned.sortedByCoord.out,chr2,20809257,20816535,+,13,1,14,novel,chr2:20809257-20816535
sample_5_Aligned.sortedByCoord.out,chr19,2747026,2747754,-,11,1,12,known,chr19:2747026-2747754
sample_5_Aligned.sortedByCoord.out,chr12,43268479,43277139,+,6,2,8,known,chr12:43268479-43277139
sample_5_Aligned.sortedByCoord.out,chr8,9341778,9350223,-,10,1,11,known,chr8:9341778-9350223
sample_5_Aligned.sortedByCoord.out,chr13,2713443,2721846,+,11,1,12,novel,chr13:2713443-2721846
sample_5_Aligned.sortedByCoord.out,chr17,34705586,34709208,+,7,3,10,known,chr17:34705586-34709208
sample_5_Aligned.sortedByCoord.out,chr5,26200520,26206844,+,8,0,8,novel,chr5:26200520-26206844
sample_5_Aligned.sortedByCoord.out,chr6,7938214,7943566,+,12,2,14,novel,chr6:7938214-7943566
sample_5_Aligned.sortedByCoord.out,chr4,27442018,27448714,+,8,3,11,known,chr4:27442018-27448714
sample_5_Aligned.sortedByCoord.out,chr10,8257296,8258231,+,10,4,14,novel,chr10:8257296-8258231
sample_5_Aligned.sortedByCoord.out,chr8,19395931,19404043,+,8,2,10,known,chr8:19395931-19404043
sample_5_Aligned.sortedByCoord.out,chr19,20055056,20059804,-,6,3,9,known,chr19:20055056-20059804
sample_5_Aligned.sortedByCoord.out,chr8,4722132,4724599,-,11,1,12,known,chr8:4722132-4724599
sample_5_Aligned.sortedByCoord.out,chr10,1642963,1650197,+,8,4,12,known,chr10:1642963-1650197
sample_5_Aligned.sortedByCoord.out,chr9,18988735,18992500,+,13,0,13,known,chr9:18988735-18992500
sample_5_Aligned.sortedByCoord.out,chr13,19504364,19511596,-,6,2,8,known,chr13:19504364-19511596
sample_5_Aligned.sortedByCoord.out,chr14,25886962,25888383,+,10,3,13,known,chr14:25886962-25888383
sample_5_Aligned.sortedByCoord.out,chr9,37723365,37726401,+,11,3,14,novel,chr9:37723365-37726401
sample_5_Aligned.sortedByCoord.out,chr12,12566683,12567547,-,5,1,6,known,chr12:12566683-12567547
sample_5_Aligned.sortedByCoord.out,chr5,31254644,31256211,+,11,1,12,known,chr5:31254644-31256211
sample_5_Aligned.sortedByCoord.out,chr11,9368597,9377764,+,14,1,15,known,chr11:9368597-9377764
sample_5_Aligned.sortedByCoord.out,chr12,47899226,47901904,-,7,4,11,known,chr12:47899226-47901904
sample_5_Aligned.sortedByCoord.out,chr7,30893801,30901910,-,12,2,14,known,chr7:30893801-30901910
sample_5_Aligned.sortedByCoord.out,chr15,33054322,33058524,-,10,3,13,known,chr15:33054322-33058524
sample_5_Aligned.sortedByCoord.out,chr20,49226942,49233790,-,10,1,11,known,chr20:49226942-49233790
sample_5_Aligned.sortedByCoord.out,chr18,38676851,38680202,+,10,0,10,novel,chr18:38676851-38680202
sample_5_Aligned.sortedByCoord.out,chr21,36249249,36253201,+,12,2,14,known,chr21:36249249-36253201
sample_5_Aligned.sortedByCoord.out,chr6,36048483,36053264,-,17,2,19,known,chr6:36048483-36053264
sample_5_Aligned.sortedByCoord.out,chr13,20136922,20140322,-,13,3,16,known,chr13:20136922-20140322
sample_5_Aligned.sortedByCoord.out,chr6,16243155,16245960,+,8,1,9,known,chr6:16243155-16245960
sample_5_Aligned.sortedByCoord.out,chr21,14076305,14081756,+,9,4,13,novel,chr21:14076305-14081756
sample_5_Aligned.sortedByCoord.out,chr22,40927551,40930153,+,9,3,12,known,chr22:40927551-40930153
sample_5_Aligned.sortedByCoord.out,chr7,11516059,11516786,-,9,3,12,known,chr7:11516059-11516786
sample_5_Aligned.sortedByCoord.out,chr4,43425114,43431808,+,13,1,14,known,chr4:43425114-43431808
sample_5_Aligned.sortedByCoord.out,chr10,8282373,8288274,-,6,1,7,known,chr10:8282373-8288274
sample_5_Aligned.sortedByCoord.out,chr6,11662606,11671504,-,12,2,14,known,chr6:11662606-11671504
sample_5_Aligned.sortedByCoord.out,chr2,3418494,3425618,-,10,1,11,known,chr2:3418494-3425618
sample_5_Aligned.sortedByCoord.out,chr10,44210980,44217088,-,10,2,12,known,chr10:44210980-44217088
sample_5_Aligned.sortedByCoord.out,chr7,31077320,31080964,+,10,3,13,known,chr7:31077320-31080964
sample_5_Aligned.sortedByCoord.out,chr16,18843183,18851896,+,11,2,13,known,chr16:18843183-18851896
sample_5_Aligned.sortedByCoord.out,chr1,49732437,49738667,-,7,3,10,novel,chr1:49732437-49738667
sample_5_Aligned.sortedByCoord.out,chr12,34642880,34643016,+,10,1,11,known,chr12:34642880-34643016
sample_5_Aligned.sortedByCoord.out,chr10,34810253,34814416,+,10,0,10,known,chr10:34810253-34814416
sample_5_Aligned.sortedByCoord.out,chr1,11948190,11950238,-,4,2,6,novel,chr1:11948190-11950238
sample_5_Aligned.sortedByCoord.out,chr11,25469982,25475052,+,9,0,9,novel,chr11:25469982-25475052
sample_5_Aligned.sortedByCoord.out,chr19,8379174,8387431,+,6,1,7,known,chr19:8379174-8387431
sample_5_Aligned.sortedByCoord.out,chr11,35391437,35394356,+,9,0,9,known,chr11:35391437-35394356
sample_5_Aligned.sortedByCoord.out,chr22,32162987,32169484,-,10,2,12,known,chr22:32162987-32169484
sample_5_Aligned.sortedByCoord.out,chr4,19041201,19042812,-,8,0,8,known,chr4:19041201-19042812
sample_5_Aligned.sortedByCoord.out,chr20,34895460,34902099,-,11,2,13,known,chr20:34895460-34902099
sample_5_Aligned.sortedByCoord.out,chr15,6176929,6178537,+,13,1,14,known,chr15:6176929-6178537
sample_5_Aligned.sortedByCoord.out,chr20,25717886,25726502,-,13,6,19,known,chr20:25717886-25726502
sample_5_Aligned.sortedByCoord.out,chr12,19383137,19385230,-,14,2,16,known,chr12:19383137-19385230
sample_5_Aligned.sortedByCoord.out,chr6,39536476,39545061,+,14,2,16,known,chr6:39536476-39545061
sample_5_Aligned.sortedByCoord.out,chr3,21188218,21195529,+,12,5,17,known,chr3:21188218-21195529
sample_5_Aligned.sortedByCoord.out,chr11,4344443,4345683,+,9,3,12,known,chr11:4344443-4345683
sample_5_Aligned.sortedByCoord.out,chr17,6626034,6629614,-,10,2,12,known,chr17:6626034-6629614
sample_5_Aligned.sortedByCoord.out,chr20,24041854,24049677,+,11,6,17,novel,chr20:24041854-24049677
sample_5_Aligned.sortedByCoord.out,chr2,35506163,35513249,-,6,3,9,known,chr2:35506163-35513249
sample_5_Aligned.sortedByCoord.out,chr9,1554046,1562282,-,13,0,13,novel,chr9:1554046-1562282
sample_5_Aligned.sortedByCoord.out,chr12,32326862,32327682,+,10,2,12,known,chr12:32326862-32327682
sample_5_Aligned.sortedByCoord.out,chr18,16105438,16108257,+,11,4,15,known,chr18:16105438-16108257
sample_5_Aligned.sortedByCoord.out,chr22,36979249,36983214,-,8,7,15,novel,chr22:36979249-36983214
sample_5_Aligned.sortedByCoord.out,chr6,39864007,39873782,+,7,3,10,novel,chr6:39864007-39873782
sample_5_Aligned.sortedByCoord.out,chr7,27260610,27261496,+,15,2,17,novel,chr7:27260610-27261496
sample_5_Aligned.sortedByCoord.out,chr3,37396925,37401030,-,9,3,12,novel,chr3:37396925-37401030
sample_5_Aligned.sortedByCoord.out,chr8,24149878,24159554,+,13,1,14,novel,chr8:24149878-24159554
sample_5_Aligned.sortedByCoord.out,chr8,45959166,45962842,-,11,0,11,known,chr8:45959166-45962842
sample_5_Aligned.sortedByCoord.out,chr2,27027718,27035345,+,14,0,14,known,chr2:27027718-27035345
sample_5_Aligned.sortedByCoord.out,chr9,23320156,23321530,-,7,2,9,novel,chr9:23320156-23321530
sample_5_Aligned.sortedByCoord.out,chr22,30366952,30374232,+,10,2,12,known,chr22:30366952-30374232
sample_5_Aligned.sortedByCoord.out,chr14,32449871,32455763,-,14,1,15,known,chr14:32449871-32455763
sample_5_Aligned.sortedByCoord.out,chr7,47694412,47700841,+,13,2,15,known,chr7:47694412-47700841
sample_5_Aligned.sortedByCoord.out,chr14,10266350,10269084,+,10,1,11,known,chr14:10266350-10269084
sample_5_Aligned.sortedByCoord.out,chr9,1969968,1974258,+,11,1,12,known,chr9:1969968-1974258
sample_5_Aligned.sortedByCoord.out,chr5,15975163,15976445,+,12,5,17,novel,chr5:15975163-15976445
sample_5_Aligned.sortedByCoord.out,chr18,43567669,43569120,+,8,1,9,known,chr18:43567669-43569120
sample_5_Aligned.sortedByCoord.out,chr10,10340439,10349049,-,14,0,14,known,chr10:10340439-10349049
sample_5_Aligned.sortedByCoord.out,chr5,6799562,6809351,+,10,2,12,known,chr5:6799562-6809351
sample_5_Aligned.sortedByCoord.out,chr15,8891826,8899270,-,8,2,10,known,chr15:8891826-8899270
sample_5_Aligned.sortedByCoord.out,chr12,47221935,47224163,+,8,2,10,known,chr12:47221935-47224163
sample_5_Aligned.sortedByCoord.out,chr18,10748570,10749199,-,13,1,14,novel,chr18:10748570-10749199
sample_5_Aligned.sortedByCoord.out,chr13,11695662,11700202,+,7,0,7,known,chr13:11695662-11700202
sample_5_Aligned.sortedByCoord.out,chr9,47130033,47136279,-,7,1,8,novel,chr9:47130033-47136279
sample_5_Aligned.sortedByCoord.out,chr7,49173335,49174680,-,9,2,11,known,chr7:49173335-49174680
sample_5_Aligned.sortedByCoord.out,chr14,49136799,49143616,+,14,10,24,novel,chr14:49136799-49143616
sample_5_Aligned.sortedByCoord.out,chr9,16084911,16090527,+,7,0,7,known,chr9:16084911-16090527
sample_5_Aligned.sortedByCoord.out,chr22,45599947,45606705,+,7,1,8,known,chr22:45599947-45606705
sample_5_Aligned.sortedByCoord.out,chr17,40454483,40463320,+,5,0,5,known,chr17:40454483-40463320
sample_5_Aligned.sortedByCoord.out,chr19,30467128,30468342,-,12,2,14,known,chr19:30467128-30468342
sample_5_Aligned.sortedByCoord.out,chr11,43072943,43082420,+,6,4,10,known,chr11:43072943-43082420
sample_5_Aligned.sortedByCoord.out,chr12,18428967,18437003,-,6,3,9,known,chr12:18428967-18437003
sample_5_Aligned.sortedByCoord.out,chr18,39640628,39642848,-,15,0,15,known,chr18:39640628-39642848
sample_5_Aligned.sortedByCoord.out,chr10,13858157,13862467,+,6,2,8,known,chr10:13858157-13862467
sample_5_Aligned.sortedByCoord.out,chr11,40430531,40431893,-,11,0,11,novel,chr11:40430531-40431893
sample_5_Aligned.sortedByCoord.out,chr22,44364400,44366001,-,9,3,12,known,chr22:44364400-44366001
sample_5_Aligned.sortedByCoord.out,chr3,9497940,9507519,-,14,0,14,known,chr3:9497940-9507519
sample_5_Aligned.sortedByCoord.out,chr14,32632180,32634440,-,8,0,8,known,chr14:32632180-32634440
sample_5_Aligned.sortedByCoord.out,chr6,34723674,34728967,-,8,1,9,known,chr6:34723674-34728967
sample_5_Aligned.sortedByCoord.out,chr22,23591301,23598908,-,7,1,8,known,chr22:23591301-23598908
sample_5_Aligned.sortedByCoord.out,chr9,11803543,11803853,-,10,2,12,known,chr9:11803543-11803853
sample_5_Aligned.sortedByCoord.out,chr21,21858083,21866412,-,13,3,16,known,chr21:21858083-21866412
sample_5_Aligned.sortedByCoord.out,chr16,2502951,2509236,+,10,4,14,known,chr16:2502951-2509236
sample_5_Aligned.sortedByCoord.out,chr19,37638522,37638841,+,7,2,9,known,chr19:37638522-37638841
sample_5_Aligned.sortedByCoord.out,chr17,21521817,21527412,+,8,4,12,novel,chr17:21521817-21527412
sample_5_Aligned.sortedByCoord.out,chr15,18969634,18970292,+,8,2,10,known,chr15:18969634-18970292
sample_5_Aligned.sortedByCoord.out,chr12,36877245,36878738,-,15,1,16,known,chr12:36877245-36878738
sample_5_Aligned.sortedByCoord.out,chr9,43344467,43351624,-,8,1,9,novel,chr9:43344467-43351624
sample_5_Aligned.sortedByCoord.out,chr13,22382519,22386975,-,8,2,10,known,chr13:22382519-22386975
sample_5_Aligned.sortedByCoord.out,chr20,1269225,1277110,+,7,3,10,known,chr20:1269225-1277110
sample_5_Aligned.sortedByCoord.out,chr17,22777732,22786439,+,15,1,16,known,chr17:22777732-22786439
sample_5_Aligned.sortedByCoord.out,chr15,30045502,30047165,+,8,1,9,known,chr15:30045502-30047165
sample_5_Aligned.sortedByCoord.out,chr4,3770323,3770979,+,9,1,10,known,chr4:3770323-3770979
sample_5_Aligned.sortedByCoord.out,chr14,42762369,42768136,+,10,3,13,known,chr14:42762369-42768136
sample_5_Aligned.sortedByCoord.out,chr7,37489419,37498642,+,14,2,16,known,chr7:37489419-37498642
sample_5_Aligned.sortedByCoord.out,chr17,31406851,31411644,+,6,2,8,known,chr17:31406851-31411644
sample_5_Aligned.sortedByCoord.out,chr18,44167968,44175649,-,8,3,11,known,chr18:44167968-44175649
sample_5_Aligned.sortedByCoord.out,chr10,48843018,48852906,+,14,0,14,novel,chr10:48843018-48852906
sample_5_Aligned.sortedByCoord.out,chr16,29979758,29981231,+,6,1,7,known,chr16:29979758-29981231
sample_5_Aligned.sortedByCoord.out,chr5,25471678,25475848,-,12,2,14,known,chr5:25471678-25475848
sample_5_Aligned.sortedByCoord.out,chr16,2941885,2943249,-,16,1,17,known,chr16:2941885-2943249
sample_5_Aligned.sortedByCoord.out,chr18,30145043,30145236,-,16,2,18,known,chr18:30145043-30145236
sample_5_Aligned.sortedByCoord.out,chr20,23850995,23855619,+,10,4,14,known,chr20:23850995-23855619
sample_5_Aligned.sortedByCoord.out,chr18,48696107,48700769,-,8,2,10,known,chr18:48696107-48700769
sample_5_Aligned.sortedByCoord.out,chr8,21142777,21147173,-,15,1,16,known,chr8:21142777-21147173
sample_5_Aligned.sortedByCoord.out,chr6,19501252,19510977,-,10,2,12,known,chr6:19501252-19510977
sample_5_Aligned.sortedByCoord.out,chr2,7821883,7823692,+,10,4,14,novel,chr2:7821883-7823692
sample_5_Aligned.sortedByCoord.out,chr1,32623113,32630223,-,6,2,8,novel,chr1:32623113-32630223
sample_5_Aligned.sortedByCoord.out,chr6,28977254,28985506,-,10,4,14,novel,chr6:28977254-28985506
sample_5_Aligned.sortedByCoord.out,chr6,8444713,8449516,-,15,3,18,novel,chr6:8444713-8449516
sample_5_Aligned.sortedByCoord.out,chr19,16479648,16488643,-,3,1,4,known,chr19:16479648-16488643
sample_5_Aligned.sortedByCoord.out,chr21,24162580,24163375,-,16,6,22,known,chr21:24162580-24163375
sample_5_Aligned.sortedByCoord.out,chr13,9711834,9716343,-,6,1,7,known,chr13:9711834-9716343
sample_5_Aligned.sortedByCoord.out,chr21,29676492,29680647,+,6,1,7,known,chr21:29676492-29680647
sample_5_Aligned.sortedByCoord.out,chr14,12690466,12692444,-,11,3,14,known,chr14:12690466-12692444
sample_5_Aligned.sortedByCoord.out,chr6,10483127,10492538,-,7,2,9,known,chr6:10483127-10492538
sample_5_Aligned.sortedByCoord.out,chr16,2992009,2996150,+,11,3,14,known,chr16:2992009-2996150
sample_5_Aligned.sortedByCoord.out,chr16,1730579,1732918,-,12,2,14,known,chr16:1730579-1732918
sample_5_Aligned.sortedByCoord.out,chr11,32694898,32697640,-,11,1,12,novel,chr11:32694898-32697640
sample_5_Aligned.sortedByCoord.out,chr9,8201572,8204241,-,17,3,20,known,chr9:8201572-8204241
sample_5_Aligned.sortedByCoord.out,chr9,25817796,25824208,-,19,0,19,known,chr9:25817796-25824208
sample_5_Aligned.sortedByCoord.out,chr4,15542156,15543433,-,11,3,14,known,chr4:15542156-15543433
sample_5_Aligned.sortedByCoord.out,chr9,1541869,1543050,+,10,1,11,known,chr9:1541869-1543050
sample_5_Aligned.sortedByCoord.out,chr14,37389991,37393737,+,12,2,14,novel,chr14:37389991-37393737
sample_5_Aligned.sortedByCoord.out,chr5,34174397,34182891,-,7,3,10,known,chr5:34174397-34182891
sample_5_Aligned.sortedByCoord.out,chr5,24214722,24216440,-,9,3,12,novel,chr5:24214722-24216440
sample_5_Aligned.sortedByCoord.out,chr19,44453238,44458006,-,9,4,13,known,chr19:44453238-44458006
sample_5_Aligned.sortedByCoord.out,chr5,43124545,43128798,-,5,3,8,known,chr5:43124545-43128798
sample_5_Aligned.sortedByCoord.out,chr1,4851623,4852714,+,9,1,10,known,chr1:4851623-4852714
sample_5_Aligned.sortedByCoord.out,chr1,3810729,3812495,+,9,1,10,known,chr1:3810729-3812495
sample_5_Aligned.sortedByCoord.out,chr17,43514082,43516117,+,13,3,16,known,chr17:43514082-43516117
sample_5_Aligned.sortedByCoord.out,chr15,7094265,7099767,-,2,1,3,known,chr15:7094265-7099767
sample_5_Aligned.sortedByCoord.out,chr1,27927309,27927995,-,3,1,4,known,chr1:27927309-27927995
sample_5_Aligned.sortedByCoord.out,chr7,32350027,32353245,+,8,5,13,known,chr7:32350027-32353245
sample_5_Aligned.sortedByCoord.out,chr11,20420918,20429019,-,14,0,14,known,chr11:20420918-20429019
sample_5_Aligned.sortedByCoord.out,chr5,40946607,40950526,-,5,2,7,known,chr5:40946607-40950526
sample_5_Aligned.sortedByCoord.out,chr5,34378318,34379748,+,15,2,17,known,chr5:34378318-34379748
sample_5_Aligned.sortedByCoord.out,chr17,27419374,27421160,+,10,2,12,known,chr17:27419374-27421160
sample_5_Aligned.sortedByCoord.out,chr5,49414360,49421416,+,13,3,16,known,chr5:49414360-49421416
sample_5_Aligned.sortedByCoord.out,chr12,13914698,13915381,+,11,4,15,novel,chr12:13914698-13915381
sample_5_Aligned.sortedByCoord.out,chr13,5311941,5321050,-,10,4,14,known,chr13:5311941-5321050
sample_5_Aligned.sortedByCoord.out,chr10,43719902,43729072,-,6,2,8,novel,chr10:43719902-43729072
sample_5_Aligned.sortedByCoord.out,chr13,21553717,21554302,-,15,2,17,known,chr13:21553717-21554302
sample_5_Aligned.sortedByCoord.out,chr15,49234871,49235915,-,9,1,10,known,chr15:49234871-49235915
sample_5_Aligned.sortedByCoord.out,chr13,33842607,33848935,-,11,3,14,known,chr13:33842607-33848935
sample_5_Aligned.sortedByCoord.out,chr18,6858678,6867608,+,1,2,3,novel,chr18:6858678-6867608
sample_5_Aligned.sortedByCoord.out,chr16,25940955,25949641,-,14,4,18,known,chr16:25940955-25949641
sample_5_Aligned.sortedByCoord.out,chr17,20698609,20705368,+,6,2,8,known,chr17:20698609-20705368
sample_5_Aligned.sortedByCoord.out,chr1,12319485,12323235,-,10,0,10,known,chr1:12319485-12323235
sample_5_Aligned.sortedByCoord.out,chr8,7529788,7531251,+,11,1,12,known,chr8:7529788-7531251
sample_5_Aligned.sortedByCoord.out,chr15,18461756,18470645,-,13,1,14,novel,chr15:18461756-18470645
sample_5_Aligned.sortedByCoord.out,chr15,9835310,9838382,-,14,2,16,novel,chr15:9835310-9838382
sample_5_Aligned.sortedByCoord.out,chr18,46511605,46519574,+,9,0,9,known,chr18:46511605-46519574
sample_5_Aligned.sortedByCoord.out,chr15,45963602,45964870,-,6,0,6,novel,chr15:45963602-45964870
sample_5_Aligned.sortedByCoord.out,chr7,4300263,4306516,-,19,2,21,novel,chr7:4300263-4306516
sample_5_Aligned.sortedByCoord.out,chr17,49378558,49385933,-,11,0,11,known,chr17:49378558-49385933
sample_5_Aligned.sortedByCoord.out,chr6,27253435,27260144,+,9,1,10,known,chr6:27253435-27260144
sample_5_Aligned.sortedByCoord.out,chr18,38826758,38832244,-,12,1,13,known,chr18:38826758-38832244
sample_5_Aligned.sortedByCoord.out,chr1,11267257,11270607,-,6,3,9,known,chr1:11267257-11270607
sample_5_Aligned.sortedByCoord.out,chr19,49420831,49423491,-,14,2,16,known,chr19:49420831-49423491
sample_5_Aligned.sortedByCoord.out,chr14,34430436,34431410,-,12,3,15,known,chr14:34430436-34431410
sample_5_Aligned.sortedByCoord.out,chr3,3255875,3260844,+,10,1,11,novel,chr3:3255875-3260844
sample_5_Aligned.sortedByCoord.out,chr6,14527638,14527960,-,9,1,10,known,chr6:14527638-14527960
sample_5_Aligned.sortedByCoord.out,chr18,21665466,21667337,-,10,1,11,novel,chr18:21665466-21667337
sample_5_Aligned.sortedByCoord.out,chr15,49443160,49446401,+,6,0,6,known,chr15:49443160-49446401
sample_5_Aligned.sortedByCoord.out,chr18,43392091,43398291,+,10,4,14,known,chr18:43392091-43398291
sample_5_Aligned.sortedByCoord.out,chr10,47901226,47903610,-,8,1,9,known,chr10:47901226-47903610
sample_5_Aligned.sortedByCoord.out,chr3,16498739,16507666,-,14,1,15,known,chr3:16498739-16507666
sample_5_Aligned.sortedByCoord.out,chr15,28739291,28746241,-,10,1,11,known,chr15:28739291-28746241
sample_5_Aligned.sortedByCoord.out,chr9,16937384,16945239,+,12,1,13,known,chr9:16937384-16945239
sample_5_Aligned.sortedByCoord.out,chr12,22850320,22855327,-,8,0,8,known,chr12:22850320-22855327
sample_5_Aligned.sortedByCoord.out,chr16,45915847,45916998,+,4,2,6,known,chr16:45915847-45916998
sample_5_Aligned.sortedByCoord.out,chr3,35314423,35324382,+,11,0,11,known,chr3:35314423-35324382
sample_5_Aligned.sortedByCoord.out,chr7,12154555,12157030,+,7,2,9,known,chr7:12154555-12157030
sample_5_Aligned.sortedByCoord.out,chr6,1306177,1308307,+,9,3,12,known,chr6:1306177-1308307
sample_5_Aligned.sortedByCoord.out,chr12,35356854,35357339,-,12,2,14,known,chr12:35356854-35357339
sample_5_Aligned.sortedByCoord.out,chr12,12747906,12748208,-,10,0,10,known,chr12:12747906-12748208
sample_5_Aligned.sortedByCoord.out,chr16,1492891,1501653,+,10,2,12,novel,chr16:1492891-1501653
sample_5_Aligned.sortedByCoord.out,chr7,39332051,39341845,+,7,2,9,known,chr7:39332051-39341845
sample_5_Aligned.sortedByCoord.out,chr5,12627364,12634984,+,3,1,4,novel,chr5:12627364-12634984
sample_5_Aligned.sortedByCoord.out,chr15,36166160,36170197,-,17,3,20,known,chr15:36166160-36170197
sample_5_Aligned.sortedByCoord.out,chr6,47781994,47789893,-,6,3,9,known,chr6:47781994-47789893
sample_5_Aligned.sortedByCoord.out,chr4,36253899,36260961,-,7,0,7,known,chr4:36253899-36260961
sample_5_Aligned.sortedByCoord.out,chr14,42154030,42159424,+,8,4,12,known,chr14:42154030-42159424
sample_5_Aligned.sortedByCoord.out,chr9,10594014,10595902,-,18,1,19,novel,chr9:10594014-10595902
sample_5_Aligned.sortedByCoord.out,chr17,23694548,23702347,+,9,2,11,novel,chr17:23694548-23702347
sample_5_Aligned.sortedByCoord.out,chr5,39508626,39514697,+,11,0,11,known,chr5:39508626-39514697
sample_5_Aligned.sortedByCoord.out,chr18,14657214,14663561,+,6,1,7,known,chr18:14657214-14663561
sample_5_Aligned.sortedByCoord.out,chr7,18352798,18353681,-,11,1,12,novel,chr7:18352798-18353681
sample_5_Aligned.sortedByCoord.out,chr18,25334546,25343605,-,11,4,15,known,chr18:25334546-25343605
sample_5_Aligned.sortedByCoord.out,chr4,26690135,26690298,-,11,0,11,known,chr4:26690135-26690298
sample_5_Aligned.sortedByCoord.out,chr16,32469998,32478170,+,10,1,11,known,chr16:32469998-32478170
sample_5_Aligned.sortedByCoord.out,chr19,14353617,14361617,-,13,2,15,known,chr19:14353617-14361617
sample_5_Aligned.sortedByCoord.out,chr22,40803091,40805087,-,10,3,13,known,chr22:40803091-40805087
sample_5_Aligned.sortedByCoord.out,chr4,25829660,25830486,-,11,5,16,novel,chr4:25829660-25830486
sample_5_Aligned.sortedByCoord.out,chr7,22638128,22643504,-,12,0,12,known,chr7:22638128-22643504
sample_5_Aligned.sortedByCoord.out,chr21,30799800,30800598,-,7,2,9,known,chr21:30799800-30800598
sample_5_Aligned.sortedByCoord.out,chr12,48259287,48263598,-,7,1,8,known,chr12:48259287-48263598
sample_5_Aligned.sortedByCoord.out,chr13,34903900,34905525,+,5,1,6,known,chr13:34903900-34905525
sample_5_Aligned.sortedByCoord.out,chr17,26039541,26042806,+,5,2,7,known,chr17:26039541-26042806
sample_5_Aligned.sortedByCoord.out,chr9,19584524,19589801,-,10,2,12,known,chr9:19584524-19589801
sample_5_Aligned.sortedByCoord.out,chr1,48611699,48617350,-,13,0,13,known,chr1:48611699-48617350
sample_5_Aligned.sortedByCoord.out,chr17,36305380,36307493,+,10,3,13,known,chr17:36305380-36307493
sample_5_Aligned.sortedByCoord.out,chr9,30843488,30850533,+,8,3,11,known,chr9:30843488-30850533
sample_5_Aligned.sortedByCoord.out,chr11,17431783,17435012,+,12,0,12,known,chr11:17431783-17435012
sample_5_Aligned.sortedByCoord.out,chr2,37401843,37403906,-,10,0,10,novel,chr2:37401843-37403906
sample_5_Aligned.sortedByCoord.out,chr5,25582770,25583257,-,13,7,20,known,chr5:25582770-25583257
sample_5_Aligned.sortedByCoord.out,chr11,11220542,11229427,-,11,2,13,known,chr11:11220542-11229427
sample_5_Aligned.sortedByCoord.out,chr9,7295069,7297020,-,8,1,9,known,chr9:7295069-7297020
sample_5_Aligned.sortedByCoord.out,chr21,1751807,1760392,+,12,5,17,known,chr21:1751807-1760392
sample_5_Aligned.sortedByCoord.out,chr18,41968843,41978386,+,13,3,16,known,chr18:41968843-41978386
sample_5_Aligned.sortedByCoord.out,chr4,10003862,10006614,-,11,3,14,known,chr4:10003862-10006614
sample_5_Aligned.sortedByCoord.out,chr3,44015507,44021197,-,11,3,14,novel,chr3:44015507-44021197
sample_5_Aligned.sortedByCoord.out,chr13,15779680,15780844,-,17,4,21,known,chr13:15779680-15780844
sample_5_Aligned.sortedByCoord.out,chr5,8724874,8726555,+,14,3,17,known,chr5:8724874-8726555
sample_5_Aligned.sortedByCoord.out,chr11,40161704,40165839,+,15,2,17,known,chr11:40161704-40165839
sample_5_Aligned.sortedByCoord.out,chr22,38538467,38542358,-,5,2,7,known,chr22:38538467-38542358
sample_5_Aligned.sortedByCoord.out,chr12,21533069,21535754,-,7,4,11,known,chr12:21533069-21535754
sample_5_Aligned.sortedByCoord.out,chr13,48011926,48021761,+,6,3,9,known,chr13:48011926-48021761
sample_5_Aligned.sortedByCoord.out,chr4,2532023,2539802,-,10,1,11,known,chr4:2532023-2539802
sample_5_Aligned.sortedByCoord.out,chr15,49073030,49080321,-,11,2,13,known,chr15:49073030-49080321
sample_5_Aligned.sortedByCoord.out,chr5,39889256,39898952,+,14,2,16,known,chr5:39889256-39898952
sample_5_Aligned.sortedByCoord.out,chr17,17021203,17022549,-,6,0,6,known,chr17:17021203-17022549
sample_5_Aligned.sortedByCoord.out,chr12,37032722,37033949,+,12,1,13,known,chr12:37032722-37033949
sample_5_Aligned.sortedByCoord.out,chr10,37842684,37850967,+,10,0,10,known,chr10:37842684-37850967
sample_5_Aligned.sortedByCoord.out,chr14,7624028,7632458,-,8,0,8,known,chr14:7624028-7632458
sample_5_Aligned.sortedByCoord.out,chr2,11339549,11346391,+,7,3,10,known,chr2:11339549-11346391
sample_5_Aligned.sortedByCoord.out,chr19,41333446,41334545,+,11,4,15,known,chr19:41333446-41334545
sample_5_Aligned.sortedByCoord.out,chr11,10041854,10042663,-,12,3,15,known,chr11:10041854-10042663
sample_5_Aligned.sortedByCoord.out,chr17,32710472,32712573,+,11,0,11,novel,chr17:32710472-32712573
sample_5_Aligned.sortedByCoord.out,chr10,32365377,32373188,-,11,1,12,known,chr10:32365377-32373188
sample_5_Aligned.sortedByCoord.out,chr19,47005376,47005718,-,7,0,7,known,chr19:47005376-47005718
sample_5_Aligned.sortedByCoord.out,chr19,44639049,44640170,-,7,4,11,known,chr19:44639049-44640170
sample_5_Aligned.sortedByCoord.out,chr17,40531014,40535145,-,10,1,11,known,chr17:40531014-40535145
sample_5_Aligned.sortedByCoord.out,chr13,25823978,25825415,-,8,0,8,novel,chr13:25823978-25825415
sample_5_Aligned.sortedByCoord.out,chr20,42818790,42826830,-,11,2,13,known,chr20:42818790-42826830
sample_5_Aligned.sortedByCoord.out,chr21,14343425,14352532,+,9,1,10,known,chr21:14343425-14352532
sample_5_Aligned.sortedByCoord.out,chr3,10614737,10620676,-,6,2,8,known,chr3:10614737-10620676
sample_5_Aligned.sortedByCoord.out,chr12,19168134,19177813,-,15,2,17,known,chr12:19168134-19177813
sample_5_Aligned.sortedByCoord.out,chr6,38182188,38186552,+,13,0,13,known,chr6:38182188-38186552
sample_5_Aligned.sortedByCoord.out,chr11,17907211,17907880,-,8,0,8,known,chr11:17907211-17907880
sample_5_Aligned.sortedByCoord.out,chr22,30423207,30428260,-,10,0,10,novel,chr22:30423207-30428260
sample_5_Aligned.sortedByCoord.out,chr17,23944475,23945745,-,8,4,12,known,chr17:23944475-23945745
sample_5_Aligned.sortedByCoord.out,chr9,40621678,40626348,+,15,2,17,known,chr9:40621678-40626348
sample_5_Aligned.sortedByCoord.out,chr22,29236601,29239268,+,13,1,14,novel,chr22:29236601-29239268
sample_5_Aligned.sortedByCoord.out,chr9,26843757,26843980,+,8,3,11,known,chr9:26843757-26843980
sample_5_Aligned.sortedByCoord.out,chr17,34811512,34817612,-,11,3,14,known,chr17:34811512-34817612
sample_5_Aligned.sortedByCoord.out,chr6,47088673,47095741,-,11,5,16,known,chr6:47088673-47095741
sample_5_Aligned.sortedByCoord.out,chr18,28444217,28453925,-,9,3,12,known,chr18:28444217-28453925
sample_5_Aligned.sortedByCoord.out,chr13,8147935,8151752,-,11,3,14,known,chr13:8147935-8151752
sample_5_Aligned.sortedByCoord.out,chr18,48670932,48680105,-,14,1,15,known,chr18:48670932-48680105
sample_5_Aligned.sortedByCoord.out,chr20,39928357,39935682,+,10,2,12,known,chr20:39928357-39935682
sample_5_Aligned.sortedByCoord.out,chr4,41787585,41791353,-,14,2,16,known,chr4:41787585-41791353
sample_5_Aligned.sortedByCoord.out,chr11,2224850,2233746,+,13,1,14,known,chr11:2224850-2233746
sample_5_Aligned.sortedByCoord.out,chr15,34480711,34482082,+,11,0,11,novel,chr15:34480711-34482082
sample_5_Aligned.sortedByCoord.out,chr2,42608354,42614189,+,11,5,16,known,chr2:42608354-42614189
sample_5_Aligned.sortedByCoord.out,chr4,10489137,10493045,+,9,2,11,known,chr4:10489137-10493045
sample_5_Aligned.sortedByCoord.out,chr8,5463049,5469061,-,13,5,18,novel,chr8:5463049-5469061
sample_5_Aligned.sortedByCoord.out,chr21,32016722,32022898,-,7,2,9,known,chr21:32016722-32022898
sample_5_Aligned.sortedByCoord.out,chr15,45575958,45583142,+,14,2,16,known,chr15:45575958-45583142
sample_5_Aligned.sortedByCoord.out,chr22,9128327,9136850,-,10,0,10,known,chr22:9128327-9136850
sample_5_Aligned.sortedByCoord.out,chr8,12073427,12081684,+,13,3,16,known,chr8:12073427-12081684
sample_5_Aligned.sortedByCoord.out,chr15,3682283,3687025,+,11,4,15,known,chr15:3682283-3687025
sample_5_Aligned.sortedByCoord.out,chr15,18311170,18318934,+,7,4,11,known,chr15:18311170-18318934
sample_5_Aligned.sortedByCoord.out,chr19,18977359,18979196,+,11,1,12,known,chr19:18977359-18979196
sample_5_Aligned.sortedByCoord.out,chr18,26500238,26500749,-,11,0,11,novel,chr18:26500238-26500749
sample_5_Aligned.sortedByCoord.out,chr14,43828776,43836060,+,19,1,20,known,chr14:43828776-43836060
sample_5_Aligned.sortedByCoord.out,chr4,36220136,36228600,-,7,3,10,known,chr4:36220136-36228600
sample_5_Aligned.sortedByCoord.out,chr2,19368197,19372361,-,9,0,9,novel,chr2:19368197-19372361
sample_5_Aligned.sortedByCoord.out,chr20,19598880,19607623,-,5,1,6,known,chr20:19598880-19607623
sample_5_Aligned.sortedByCoord.out,chr11,31193423,31195941,+,12,3,15,known,chr11:31193423-31195941
sample_5_Aligned.sortedByCoord.out,chr21,6621875,6624748,+,12,1,13,known,chr21:6621875-6624748
sample_5_Aligned.sortedByCoord.out,chr13,32347609,32356819,-,13,1,14,known,chr13:32347609-32356819
sample_5_Aligned.sortedByCoord.out,chr2,48514987,48518307,-,14,2,16,known,chr2:48514987-48518307
sample_5_Aligned.sortedByCoord.out,chr15,34410132,34412732,+,7,3,10,known,chr15:34410132-34412732
sample_5_Aligned.sortedByCoord.out,chr10,28566218,28571762,-,8,3,11,known,chr10:28566218-28571762
sample_5_Aligned.sortedByCoord.out,chr17,24814787,24823991,-,13,0,13,known,chr17:24814787-24823991
sample_5_Aligned.sortedByCoord.out,chr14,37539066,37542828,+,5,1,6,known,chr14:37539066-37542828
sample_5_Aligned.sortedByCoord.out,chr1,15404746,15411662,-,10,5,15,known,chr1:15404746-15411662
sample_5_Aligned.sortedByCoord.out,chr7,23295052,23302781,+,9,1,10,known,chr7:23295052-23302781
sample_5_Aligned.sortedByCoord.out,chr17,10652406,10660311,-,14,1,15,known,chr17:10652406-10660311
sample_5_Aligned.sortedByCoord.out,chr20,46499952,46501653,-,7,1,8,known,chr20:46499952-46501653
sample_5_Aligned.sortedByCoord.out,chr10,25010125,25010934,-,12,1,13,novel,chr10:25010125-25010934
sample_5_Aligned.sortedByCoord.out,chr3,22560270,22565657,-,11,2,13,known,chr3:22560270-22565657
sample_5_Aligned.sortedByCoord.out,chr4,37619656,37625576,+,14,4,18,known,chr4:37619656-37625576
sample_5_Aligned.sortedByCoord.out,chr4,15990420,15994685,-,5,4,9,known,chr4:15990420-15994685
sample_5_Aligned.sortedByCoord.out,chr6,34371629,34373342,-,13,4,17,novel,chr6:34371629-34373342
sample_5_Aligned.sortedByCoord.out,chr16,47822763,47828535,+,12,3,15,known,chr16:47822763-47828535
sample_5_Aligned.sortedByCoord.out,chr19,21300218,21306281,-,8,2,10,novel,chr19:21300218-21306281
sample_5_Aligned.sortedByCoord.out,chr15,35378426,35385529,-,10,2,12,known,chr15:35378426-35385529
sample_5_Aligned.sortedByCoord.out,chr3,21652747,21659785,+,4,1,5,known,chr3:21652747-21659785
sample_5_Aligned.sortedByCoord.out,chr6,46881699,46890177,+,11,2,13,known,chr6:46881699-46890177
sample_5_Aligned.sortedByCoord.out,chr10,47790091,47796087,+,8,3,11,known,chr10:47790091-47796087
sample_5_Aligned.sortedByCoord.out,chr9,40495494,40498741,+,13,1,14,known,chr9:40495494-40498741
sample_5_Aligned.sortedByCoord.out,chr18,13454589,13461714,-,11,1,12,known,chr18:13454589-13461714
sample_5_Aligned.sortedByCoord.out,chr3,7081235,7086941,-,11,3,14,known,chr3:7081235-7086941
sample_5_Aligned.sortedByCoord.out,chr2,22537480,22544797,-,14,2,16,known,chr2:22537480-22544797
sample_5_Aligned.sortedByCoord.out,chr15,24782109,24791147,+,9,3,12,known,chr15:24782109-24791147
sample_5_Aligned.sortedByCoord.out,chr9,3302317,3304115,+,9,3,12,known,chr9:3302317-3304115
sample_5_Aligned.sortedByCoord.out,chr14,43053275,43060600,-,7,2,9,known,chr14:43053275-43060600
sample_5_Aligned.sortedByCoord.out,chr18,13183715,13189294,-,15,1,16,known,chr18:13183715-13189294
sample_5_Aligned.sortedByCoord.out,chr1,5156497,5163760,+,18,3,21,known,chr1:5156497-5163760
sample_5_Aligned.sortedByCoord.out,chr14,21345808,21352374,+,12,0,12,known,chr14:21345808-21352374
sample_5_Aligned.sortedByCoord.out,chr7,41674938,41677469,+,10,0,10,known,chr7:41674938-41677469
sample_5_Aligned.sortedByCoord.out,chr11,37634865,37643290,-,8,2,10,known,chr11:37634865-37643290
sample_5_Aligned.sortedByCoord.out,chr6,20605360,20614612,-,8,5,13,known,chr6:20605360-20614612
sample_5_Aligned.sortedByCoord.out,chr17,35759156,35766215,-,11,4,15,known,chr17:35759156-35766215
sample_5_Aligned.sortedByCoord.out,chr22,29280302,29284306,-,19,1,20,known,chr22:29280302-29284306
sample_5_Aligned.sortedByCoord.out,chr4,35374429,35378820,+,12,1,13,novel,chr4:35374429-35378820
sample_5_Aligned.sortedByCoord.out,chr7,42057273,42062347,+,8,0,8,known,chr7:42057273-42062347
sample_5_Aligned.sortedByCoord.out,chr3,14522748,14528123,+,9,2,11,novel,chr3:14522748-14528123
sample_5_Aligned.sortedByCoord.out,chr11,18939628,18948452,-,6,2,8,novel,chr11:18939628-18948452
sample_5_Aligned.sortedByCoord.out,chr11,35542474,35548926,-,6,3,9,known,chr11:35542474-35548926
sample_5_Aligned.sortedByCoord.out,chr13,8980992,8983071,-,4,0,4,novel,chr13:8980992-8983071
sample_5_Aligned.sortedByCoord.out,chr17,10047211,10051789,-,9,2,11,known,chr17:10047211-10051789
sample_5_Aligned.sortedByCoord.out,chr21,47468728,47475428,+,13,2,15,known,chr21:47468728-47475428
sample_5_Aligned.sortedByCoord.out,chr1,28307765,28310772,+,13,1,14,known,chr1:28307765-28310772
sample_5_Aligned.sortedByCoord.out,chr13,36027705,36032007,-,11,1,12,novel,chr13:36027705-36032007
sample_5_Aligned.sortedByCoord.out,chr15,29399947,29401145,+,9,1,10,known,chr15:29399947-29401145
sample_5_Aligned.sortedByCoord.out,chr1,15679642,15689003,+,14,3,17,known,chr1:15679642-15689003
sample_5_Aligned.sortedByCoord.out,chr5,7576984,7579981,+,9,4,13,known,chr5:7576984-7579981
sample_5_Aligned.sortedByCoord.out,chr1,9474444,9478152,-,7,3,10,known,chr1:9474444-9478152
sample_5_Aligned.sortedByCoord.out,chr19,24066291,24072505,-,9,1,10,novel,chr19:24066291-24072505
sample_5_Aligned.sortedByCoord.out,chr8,47314340,47315975,-,9,0,9,known,chr8:47314340-47315975
sample_5_Aligned.sortedByCoord.out,chr1,49080085,49086448,-,10,2,12,known,chr1:49080085-49086448
sample_5_Aligned.sortedByCoord.out,chr16,18750156,18759121,+,7,1,8,known,chr16:18750156-18759121
sample_5_Aligned.sortedByCoord.out,chr14,34236107,34243611,-,12,3,15,known,chr14:34236107-34243611
sample_5_Aligned.sortedByCoord.out,chr8,32659437,32667501,+,10,4,14,novel,chr8:32659437-32667501
sample_5_Aligned.sortedByCoord.out,chr1,37192423,37199419,+,8,0,8,known,chr1:37192423-37199419
sample_5_Aligned.sortedByCoord.out,chr14,1989626,1994158,-,8,2,10,known,chr14:1989626-1994158
sample_5_Aligned.sortedByCoord.out,chr18,4496542,4503321,-,3,2,5,known,chr18:4496542-4503321
sample_5_Aligned.sortedByCoord.out,chr15,14061965,14071760,+,9,1,10,known,chr15:14061965-14071760
sample_5_Aligned.sortedByCoord.out,chr2,42691500,42692069,-,13,3,16,known,chr2:42691500-42692069
sample_5_Aligned.sortedByCoord.out,chr19,44314700,44322098,-,10,1,11,known,chr19:44314700-44322098
sample_5_Aligned.sortedByCoord.out,chr7,15686251,15696115,-,8,2,10,known,chr7:15686251-15696115
sample_5_Aligned.sortedByCoord.out,chr3,15329662,15336501,+,13,2,15,known,chr3:15329662-15336501
sample_5_Aligned.sortedByCoord.out,chr6,9878182,9887218,+,7,3,10,known,chr6:9878182-9887218
sample_5_Aligned.sortedByCoord.out,chr7,45491490,45497860,+,10,1,11,known,chr7:45491490-45497860
sample_5_Aligned.sortedByCoord.out,chr13,18979478,18984251,-,10,1,11,known,chr13:18979478-18984251
sample_5_Aligned.sortedByCoord.out,chr20,10929219,10934771,+,5,1,6,novel,chr20:10929219-10934771
sample_5_Aligned.sortedByCoord.out,chr11,6174919,6176043,-,4,0,4,known,chr11:6174919-6176043
sample_5_Aligned.sortedByCoord.out,chr20,21691010,21694136,-,10,1,11,known,chr20:21691010-21694136
sample_5_Aligned.sortedByCoord.out,chr3,26195435,26200795,-,8,3,11,novel,chr3:26195435-26200795
sample_5_Aligned.sortedByCoord.out,chr17,8933504,8938687,-,11,3,14,novel,chr17:8933504-8938687
sample_5_Aligned.sortedByCoord.out,chr4,44292001,44296231,+,8,3,11,known,chr4:44292001-44296231
sample_5_Aligned.sortedByCoord.out,chr4,16025525,16030095,+,9,1,10,known,chr4:16025525-16030095
sample_5_Aligned.sortedByCoord.out,chr18,11710854,11713603,+,19,2,21,known,chr18:11710854-11713603
sample_5_Aligned.sortedByCoord.out,chr9,46155655,46160645,-,9,0,9,known,chr9:46155655-46160645
sample_5_Aligned.sortedByCoord.out,chr21,1283569,1285089,+,10,1,11,novel,chr21:1283569-1285089
sample_5_Aligned.sortedByCoord.out,chr12,10216631,10224754,-,10,1,11,known,chr12:10216631-10224754
sample_5_Aligned.sortedByCoord.out,chr5,23450357,23451297,-,9,4,13,novel,chr5:23450357-23451297
sample_5_Aligned.sortedByCoord.out,chr18,23768486,23772568,+,8,2,10,known,chr18:23768486-23772568
sample_5_Aligned.sortedByCoord.out,chr9,39284704,39290638,+,9,0,9,known,chr9:39284704-39290638
sample_5_Aligned.sortedByCoord.out,chr3,24190173,24190561,-,14,2,16,known,chr3:24190173-24190561
sample_5_Aligned.sortedByCoord.out,chr14,39153184,39159788,+,9,2,11,known,chr14:39153184-39159788
sample_5_Aligned.sortedByCoord.out,chr3,3360715,3361533,-,18,2,20,novel,chr3:3360715-3361533
sample_5_Aligned.sortedByCoord.out,chr4,39102028,39110011,+,6,3,9,known,chr4:39102028-39110011
sample_5_Aligned.sortedByCoord.out,chr2,36538563,36540538,-,7,2,9,novel,chr2:36538563-36540538
sample_5_Aligned.sortedByCoord.out,chr9,26985183,26989309,+,10,0,10,known,chr9:26985183-26989309
sample_5_Aligned.sortedByCoord.out,chr15,12671311,12676204,-,10,1,11,known,chr15:12671311-12676204
sample_5_Aligned.sortedByCoord.out,chr10,4915363,4915829,-,5,2,7,known,chr10:4915363-4915829
sample_5_Aligned.sortedByCoord.out,chr8,25249779,25257179,-,6,3,9,known,chr8:25249779-25257179
sample_5_Aligned.sortedByCoord.out,chr21,40539631,40546958,-,11,3,14,known,chr21:40539631-40546958
sample_5_Aligned.sortedByCoord.out,chr2,3989477,3993923,+,8,3,11,known,chr2:3989477-3993923
sample_5_Aligned.sortedByCoord.out,chr20,28474606,28475068,+,12,3,15,known,chr20:28474606-28475068
sample_5_Aligned.sortedByCoord.out,chr18,7065915,7067914,+,12,2,14,known,chr18:7065915-7067914
sample_5_Aligned.sortedByCoord.out,chr3,5255124,5264892,+,7,1,8,known,chr3:5255124-5264892
sample_5_Aligned.sortedByCoord.out,chr16,7103795,7108477,-,14,1,15,known,chr16:7103795-7108477
sample_5_Aligned.sortedByCoord.out,chr20,35248579,35255514,+,5,0,5,known,chr20:35248579-35255514
sample_5_Aligned.sortedByCoord.out,chr18,4116333,4125957,+,7,0,7,known,chr18:4116333-4125957
sample_5_Aligned.sortedByCoord.out,chr4,16765277,16767138,+,7,3,10,known,chr4:16765277-16767138
sample_5_Aligned.sortedByCoord.out,chr12,38638842,38648540,+,7,1,8,known,chr12:38638842-38648540
sample_5_Aligned.sortedByCoord.out,chr5,28399461,28408339,+,5,1,6,known,chr5:28399461-28408339
sample_5_Aligned.sortedByCoord.out,chr5,28949482,28954434,-,15,2,17,known,chr5:28949482-28954434
sample_5_Aligned.sortedByCoord.out,chr13,37442630,37452315,+,11,1,12,known,chr13:37442630-37452315
sample_5_Aligned.sortedByCoord.out,chr9,39137625,39146650,+,7,2,9,known,chr9:39137625-39146650
sample_5_Aligned.sortedByCoord.out,chr21,3127913,3131154,+,10,2,12,known,chr21:3127913-3131154
sample_5_Aligned.sortedByCoord.out,chr16,11612540,11620210,-,8,3,11,known,chr16:11612540-11620210
sample_5_Aligned.sortedByCoord.out,chr17,49126407,49135302,-,13,4,17,known,chr17:49126407-49135302
sample_5_Aligned.sortedByCoord.out,chr9,37446279,37446736,-,15,2,17,known,chr9:37446279-37446736
sample_5_Aligned.sortedByCoord.out,chr3,14464869,14468484,-,6,1,7,known,chr3:14464869-14468484
sample_5_Aligned.sortedByCoord.out,chr18,47546204,47549066,-,7,1,8,known,chr18:47546204-47549066
sample_5_Aligned.sortedByCoord.out,chr3,21649692,21659274,+,18,0,18,known,chr3:21649692-21659274
sample_5_Aligned.sortedByCoord.out,chr15,6789812,6799720,-,11,0,11,known,chr15:6789812-6799720
sample_5_Aligned.sortedByCoord.out,chr16,12081716,12088719,+,13,4,17,known,chr16:12081716-12088719
sample_5_Aligned.sortedByCoord.out,chr2,36790083,36799850,-,16,2,18,known,chr2:36790083-36799850
sample_5_Aligned.sortedByCoord.out,chr4,35575044,35581387,-,12,1,13,known,chr4:35575044-35581387
sample_5_Aligned.sortedByCoord.out,chr19,3933335,3934593,+,14,1,15,known,chr19:3933335-3934593
sample_5_Aligned.sortedByCoord.out,chr20,26155556,26161627,+,6,2,8,known,chr20:26155556-26161627
sample_5_Aligned.sortedByCoord.out,chr11,25900097,25906519,+,13,1,14,novel,chr11:25900097-25906519
sample_5_Aligned.sortedByCoord.out,chr3,40353127,40353943,+,12,2,14,known,chr3:40353127-40353943
sample_5_Aligned.sortedByCoord.out,chr8,19333134,19333750,-,6,3,9,novel,chr8:19333134-19333750
sample_5_Aligned.sortedByCoord.out,chr6,4874262,4881198,+,10,3,13,known,chr6:4874262-4881198
sample_5_Aligned.sortedByCoord.out,chr21,5255939,5256222,+,12,2,14,novel,chr21:5255939-5256222
sample_5_Aligned.sortedByCoord.out,chr8,7237284,7241929,-,11,5,16,known,chr8:7237284-7241929
sample_5_Aligned.sortedByCoord.out,chr2,7692753,7698019,+,8,4,12,known,chr2:7692753-7698019
sample_5_Aligned.sortedByCoord.out,chr16,7964878,7973753,+,10,1,11,novel,chr16:7964878-7973753
sample_5_Aligned.sortedByCoord.out,chr5,30609240,30617059,+,12,3,15,known,chr5:30609240-30617059
sample_5_Aligned.sortedByCoord.out,chr8,19606368,19608219,+,11,2,13,known,chr8:19606368-19608219
sample_5_Aligned.sortedByCoord.out,chr22,16108362,16110010,+,12,1,13,known,chr22:16108362-16110010
sample_5_Aligned.sortedByCoord.out,chr2,29191483,29197899,+,10,0,10,known,chr2:29191483-29197899
sample_5_Aligned.sortedByCoord.out,chr3,47799515,47800401,+,17,2,19,known,chr3:47799515-47800401
sample_5_Aligned.sortedByCoord.out,chr15,48678919,48686189,+,8,0,8,known,chr15:48678919-48686189
sample_5_Aligned.sortedByCoord.out,chr19,22594755,22603448,-,16,1,17,known,chr19:22594755-22603448
sample_5_Aligned.sortedByCoord.out,chr16,2500867,2501121,+,10,0,10,novel,chr16:2500867-2501121
sample_5_Aligned.sortedByCoord.out,chr7,10197062,10198754,+,8,4,12,novel,chr7:10197062-10198754
sample_5_Aligned.sortedByCoord.out,chr7,13566139,13576123,-,11,3,14,known,chr7:13566139-13576123
sample_5_Aligned.sortedByCoord.out,chr7,3628118,3632878,-,12,1,13,known,chr7:3628118-3632878
sample_5_Aligned.sortedByCoord.out,chr3,25728000,25737724,-,4,3,7,known,chr3:25728000-25737724
sample_5_Aligned.sortedByCoord.out,chr2,42889922,42896958,-,12,0,12,known,chr2:42889922-42896958
sample_5_Aligned.sortedByCoord.out,chr19,39296292,39296619,-,10,2,12,known,chr19:39296292-39296619
sample_5_Aligned.sortedByCoord.out,chr13,6350507,6351098,+,11,1,12,known,chr13:6350507-6351098
sample_5_Aligned.sortedByCoord.out,chr15,29095895,29105667,+,12,3,15,known,chr15:29095895-29105667
sample_5_Aligned.sortedByCoord.out,chr15,17554097,17559991,+,11,4,15,novel,chr15:17554097-17559991
sample_5_Aligned.sortedByCoord.out,chr12,28559543,28566378,+,10,1,11,known,chr12:28559543-28566378
sample_5_Aligned.sortedByCoord.out,chr3,31043496,31044499,+,11,2,13,known,chr3:31043496-31044499
sample_5_Aligned.sortedByCoord.out,chr1,13053553,13062672,+,16,2,18,known,chr1:13053553-13062672
sample_5_Aligned.sortedByCoord.out,chr8,19537032,19543423,-,7,0,7,known,chr8:19537032-19543423
sample_5_Aligned.sortedByCoord.out,chr5,42687052,42687500,+,12,1,13,known,chr5:42687052-42687500
sample_5_Aligned.sortedByCoord.out,chr16,48503717,48504949,+,11,1,12,known,chr16:48503717-48504949
sample_5_Aligned.sortedByCoord.out,chr14,42141030,42144814,+,13,3,16,known,chr14:42141030-42144814
sample_5_Aligned.sortedByCoord.out,chr5,19935214,19935971,+,9,3,12,known,chr5:19935214-19935971
sample_5_Aligned.sortedByCoord.out,chr17,28758492,28768034,+,8,1,9,known,chr17:28758492-28768034
sample_5_Aligned.sortedByCoord.out,chr5,18535301,18542810,+,9,2,11,known,chr5:18535301-18542810
sample_5_Aligned.sortedByCoord.out,chr6,28175478,28179423,+,11,3,14,novel,chr6:28175478-28179423
sample_5_Aligned.sortedByCoord.out,chr6,43389491,43392748,+,5,2,7,novel,chr6:43389491-43392748
sample_5_Aligned.sortedByCoord.out,chr9,21312504,21318501,-,10,2,12,known,chr9:21312504-21318501
sample_5_Aligned.sortedByCoord.out,chr14,9379249,9384598,+,6,4,10,known,chr14:9379249-9384598
sample_5_Aligned.sortedByCoord.out,chr12,42298942,42306213,-,11,3,14,known,chr12:42298942-42306213
sample_5_Aligned.sortedByCoord.out,chr16,4529398,4538069,+,7,2,9,novel,chr16:4529398-4538069
sample_5_Aligned.sortedByCoord.out,chr4,30751380,30754354,+,10,2,12,novel,chr4:30751380-30754354
sample_5_Aligned.sortedByCoord.out,chr1,9262895,9268211,+,10,2,12,known,chr1:9262895-9268211
sample_5_Aligned.sortedByCoord.out,chr3,30997395,31003019,-,10,2,12,known,chr3:30997395-31003019
sample_5_Aligned.sortedByCoord.out,chr20,15117370,15123862,+,10,0,10,known,chr20:15117370-15123862
sample_5_Aligned.sortedByCoord.out,chr9,40774762,40781326,-,11,3,14,known,chr9:40774762-40781326
sample_5_Aligned.sortedByCoord.out,chr13,13274303,13282740,-,7,2,9,known,chr13:13274303-13282740
sample_5_Aligned.sortedByCoord.out,chr5,26160410,26167151,+,5,1,6,known,chr5:26160410-26167151
sample_5_Aligned.sortedByCoord.out,chr17,18262350,18269684,-,7,2,9,known,chr17:18262350-18269684
sample_5_Aligned.sortedByCoord.out,chr9,6094501,6095979,+,4,3,7,known,chr9:6094501-6095979
sample_5_Aligned.sortedByCoord.out,chr1,26565561,26570061,+,7,1,8,known,chr1:26565561-26570061
sample_5_Aligned.sortedByCoord.out,chr20,13617126,13626689,+,6,0,6,known,chr20:13617126-13626689
sample_5_Aligned.sortedByCoord.out,chr1,5687831,5689238,+,13,3,16,novel,chr1:5687831-5689238
sample_5_Aligned.sortedByCoord.out,chr11,23866899,23871008,-,12,3,15,novel,chr11:23866899-23871008
sample_5_Aligned.sortedByCoord.out,chr2,22423540,22425855,+,7,1,8,novel,chr2:22423540-22425855
sample_5_Aligned.sortedByCoord.out,chr6,32684400,32689881,-,9,0,9,known,chr6:32684400-32689881
sample_5_Aligned.sortedByCoord.out,chr16,10597648,10605213,-,9,2,11,known,chr16:10597648-10605213
sample_5_Aligned.sortedByCoord.out,chr13,33094884,33098220,+,16,1,17,known,chr13:33094884-33098220
sample_5_Aligned.sortedByCoord.out,chr5,30123008,30123333,+,16,3,19,known,chr5:30123008-30123333
sample_5_Aligned.sortedByCoord.out,chr15,28577608,28579831,+,4,3,7,known,chr15:28577608-28579831
sample_5_Aligned.sortedByCoord.out,chr15,39264930,39266251,+,14,1,15,known,chr15:39264930-39266251
sample_5_Aligned.sortedByCoord.out,chr11,38635466,38637420,-,6,0,6,known,chr11:38635466-38637420
sample_5_Aligned.sortedByCoord.out,chr1,1477211,1486117,-,9,1,10,known,chr1:1477211-1486117
sample_5_Aligned.sortedByCoord.out,chr17,46005153,46006005,-,10,2,12,known,chr17:46005153-46006005
sample_5_Aligned.sortedByCoord.out,chr8,49532345,49535700,-,10,1,11,known,chr8:49532345-49535700
sample_5_Aligned.sortedByCoord.out,chr22,35013722,35019811,+,9,4,13,known,chr22:35013722-35019811
sample_5_Aligned.sortedByCoord.out,chr12,46935546,46944131,+,13,2,15,known,chr12:46935546-46944131
sample_5_Aligned.sortedByCoord.out,chr19,12849560,12854317,-,13,1,14,known,chr19:12849560-12854317
sample_5_Aligned.sortedByCoord.out,chr12,42009068,42018357,-,7,2,9,known,chr12:42009068-42018357
sample_5_Aligned.sortedByCoord.out,chr13,32865792,32875127,-,8,2,10,known,chr13:32865792-32875127
sample_5_Aligned.sortedByCoord.out,chr17,36170717,36174917,+,17,1,18,known,chr17:36170717-36174917
sample_5_Aligned.sortedByCoord.out,chr19,24497272,24505094,+,8,5,13,known,chr19:24497272-24505094
sample_5_Aligned.sortedByCoord.out,chr4,36124009,36125593,-,12,0,12,known,chr4:36124009-36125593
sample_5_Aligned.sortedByCoord.out,chr12,21554810,21561438,+,7,0,7,novel,chr12:21554810-21561438
sample_5_Aligned.sortedByCoord.out,chr1,12505924,12509198,-,8,5,13,known,chr1:12505924-12509198
sample_5_Aligned.sortedByCoord.out,chr13,33293282,33303038,+,4,3,7,known,chr13:33293282-33303038
sample_5_Aligned.sortedByCoord.out,chr21,48578589,48580394,+,11,2,13,known,chr21:48578589-48580394
sample_5_Aligned.sortedByCoord.out,chr14,28082245,28089306,-,8,3,11,known,chr14:28082245-28089306
sample_5_Aligned.sortedByCoord.out,chr5,4075822,4079195,+,10,1,11,novel,chr5:4075822-4079195
sample_5_Aligned.sortedByCoord.out,chr21,4337603,4342304,+,9,1,10,known,chr21:4337603-4342304
sample_5_Aligned.sortedByCoord.out,chr1,9676372,9685748,-,5,2,7,known,chr1:9676372-9685748
sample_5_Aligned.sortedByCoord.out,chr6,9340347,9345154,+,7,6,13,known,chr6:9340347-9345154
sample_5_Aligned.sortedByCoord.out,chr12,10400234,10404321,-,14,2,16,known,chr12:10400234-10404321
sample_5_Aligned.sortedByCoord.out,chr18,44947209,44952189,-,11,1,12,known,chr18:44947209-44952189
sample_5_Aligned.sortedByCoord.out,chr1,2290242,2295701,-,13,4,17,known,chr1:2290242-2295701
sample_5_Aligned.sortedByCoord.out,chr10,42923739,42932177,-,10,2,12,known,chr10:42923739-42932177
sample_5_Aligned.sortedByCoord.out,chr4,28425865,28427655,-,6,1,7,known,chr4:28425865-28427655
sample_5_Aligned.sortedByCoord.out,chr12,21168685,21178369,+,13,1,14,novel,chr12:21168685-21178369
sample_5_Aligned.sortedByCoord.out,chr7,41902559,41906252,-,11,1,12,novel,chr7:41902559-41906252
sample_5_Aligned.sortedByCoord.out,chr9,29411279,29414603,+,13,0,13,known,chr9:29411279-29414603
sample_5_Aligned.sortedByCoord.out,chr6,17379333,17384041,+,14,1,15,known,chr6:17379333-17384041
sample_5_Aligned.sortedByCoord.out,chr17,1895598,1901550,-,7,2,9,known,chr17:1895598-1901550
sample_5_Aligned.sortedByCoord.out,chr20,36179766,36182762,+,11,5,16,known,chr20:36179766-36182762
sample_5_Aligned.sortedByCoord.out,chr12,30175780,30177606,-,8,2,10,known,chr12:30175780-30177606
sample_5_Aligned.sortedByCoord.out,chr9,18488302,18496511,+,11,1,12,known,chr9:18488302-18496511
sample_5_Aligned.sortedByCoord.out,chr22,39998326,40004127,+,5,2,7,known,chr22:39998326-40004127
sample_5_Aligned.sortedByCoord.out,chr8,48833217,48838017,+,14,1,15,known,chr8:48833217-48838017
sample_5_Aligned.sortedByCoord.out,chr19,10388341,10392869,-,12,1,13,known,chr19:10388341-10392869
sample_5_Aligned.sortedByCoord.out,chr9,5622242,5629039,+,7,2,9,known,chr9:5622242-5629039
sample_5_Aligned.sortedByCoord.out,chr15,8098668,8106568,+,7,1,8,novel,chr15:8098668-8106568
sample_5_Aligned.sortedByCoord.out,chr14,5157009,5160534,+,11,4,15,known,chr14:5157009-5160534
sample_5_Aligned.sortedByCoord.out,chr3,25524279,25529869,-,11,2,13,known,chr3:25524279-25529869
sample_5_Aligned.sortedByCoord.out,chr16,20226994,20234652,-,7,1,8,novel,chr16:20226994-20234652
sample_5_Aligned.sortedByCoord.out,chr19,40498779,40506428,+,11,0,11,known,chr19:40498779-40506428
sample_5_Aligned.sortedByCoord.out,chr5,41951881,41961064,+,7,0,7,novel,chr5:41951881-41961064
sample_5_Aligned.sortedByCoord.out,chr3,28540779,28542962,+,6,3,9,known,chr3:28540779-28542962
sample_5_Aligned.sortedByCoord.out,chr6,34102155,34110625,+,5,2,7,known,chr6:34102155-34110625
sample_5_Aligned.sortedByCoord.out,chr20,3230604,3232212,-,6,1,7,known,chr20:3230604-3232212
sample_5_Aligned.sortedByCoord.out,chr14,13031298,13035032,-,9,3,12,known,chr14:13031298-13035032
sample_5_Aligned.sortedByCoord.out,chr8,26142704,26151263,-,5,0,5,known,chr8:26142704-26151263
sample_5_Aligned.sortedByCoord.out,chr6,11413073,11416287,-,16,1,17,known,chr6:11413073-11416287
sample_5_Aligned.sortedByCoord.out,chr11,35443121,35448347,+,12,3,15,known,chr11:35443121-35448347
sample_5_Aligned.sortedByCoord.out,chr20,46782223,46790715,-,4,2,6,known,chr20:46782223-46790715
sample_5_Aligned.sortedByCoord.out,chr2,49161589,49163194,-,11,1,12,known,chr2:49161589-49163194
sample_5_Aligned.sortedByCoord.out,chr7,41729430,41735078,+,9,1,10,known,chr7:41729430-41735078
sample_5_Aligned.sortedByCoord.out,chr18,10853317,10862618,-,10,2,12,known,chr18:10853317-10862618
sample_5_Aligned.sortedByCoord.out,chr7,32909984,32919156,+,15,1,16,novel,chr7:32909984-32919156
sample_5_Aligned.sortedByCoord.out,chr3,23526501,23536439,+,6,1,7,known,chr3:23526501-23536439
sample_5_Aligned.sortedByCoord.out,chr2,47642283,47650222,+,16,3,19,known,chr2:47642283-47650222
sample_5_Aligned.sortedByCoord.out,chr21,36238126,36245308,+,9,1,10,known,chr21:36238126-36245308
sample_5_Aligned.sortedByCoord.out,chr4,13056483,13062377,-,20,3,23,novel,chr4:13056483-13062377
sample_5_Aligned.sortedByCoord.out,chr4,44329393,44338166,+,8,2,10,known,chr4:44329393-44338166
sample_5_Aligned.sortedByCoord.out,chr15,46996881,47000139,-,13,4,17,novel,chr15:46996881-47000139
sample_5_Aligned.sortedByCoord.out,chr14,10519705,10524609,-,13,1,14,known,chr14:10519705-10524609
sample_5_Aligned.sortedByCoord.out,chr18,11646331,11651338,-,9,0,9,known,chr18:11646331-11651338
sample_5_Aligned.sortedByCoord.out,chr3,12341633,12346824,-,6,2,8,known,chr3:12341633-12346824
sample_5_Aligned.sortedByCoord.out,chr14,38018074,38025107,+,6,3,9,known,chr14:38018074-38025107
sample_5_Aligned.sortedByCoord.out,chr14,43617660,43623269,-,13,3,16,known,chr14:43617660-43623269
sample_5_Aligned.sortedByCoord.out,chr3,24079648,24081453,-,4,1,5,known,chr3:24079648-24081453
sample_5_Aligned.sortedByCoord.out,chr9,21818635,21819508,-,8,1,9,known,chr9:21818635-21819508
sample_5_Aligned.sortedByCoord.out,chr11,33455244,33455491,+,7,5,12,known,chr11:33455244-33455491
sample_5_Aligned.sortedByCoord.out,chr22,4309706,4310756,+,14,1,15,known,chr22:4309706-4310756
sample_5_Aligned.sortedByCoord.out,chr2,17534705,17535875,-,7,0,7,known,chr2:17534705-17535875
sample_5_Aligned.sortedByCoord.out,chr3,2226234,2227829,+,6,1,7,known,chr3:2226234-2227829
sample_5_Aligned.sortedByCoord.out,chr12,31699535,31706297,+,15,1,16,known,chr12:31699535-31706297
sample_5_Aligned.sortedByCoord.out,chr17,4854590,4860337,+,12,2,14,known,chr17:4854590-4860337
sample_5_Aligned.sortedByCoord.out,chr17,21933654,21942067,-,5,2,7,novel,chr17:21933654-21942067
sample_5_Aligned.sortedByCoord.out,chr4,2874103,2880423,+,12,1,13,novel,chr4:2874103-2880423
sample_5_Aligned.sortedByCoord.out,chr13,38903479,38910136,-,9,4,13,known,chr13:38903479-38910136
sample_5_Aligned.sortedByCoord.out,chr9,32568430,32576298,+,10,0,10,known,chr9:32568430-32576298
sample_5_Aligned.sortedByCoord.out,chr5,46414499,46423371,+,7,2,9,known,chr5:46414499-46423371
sample_5_Aligned.sortedByCoord.out,chr11,14512957,14522762,+,12,3,15,novel,chr11:14512957-14522762
sample_5_Aligned.sortedByCoord.out,chr16,27012951,27013833,-,11,5,16,known,chr16:27012951-27013833
sample_5_Aligned.sortedByCoord.out,chr1,26698890,26702379,-,8,2,10,known,chr1:26698890-26702379
sample_5_Aligned.sortedByCoord.out,chr12,36389858,36391128,-,9,3,12,novel,chr12:36389858-36391128
sample_6_Aligned.sortedByCoord.out,chr20,20880950,20884348,-,6,4,10,known,chr20:20880950-20884348
sample_6_Aligned.sortedByCoord.out,chr12,22149084,22151792,-,8,2,10,known,chr12:22149084-22151792
sample_6_Aligned.sortedByCoord.out,chr6,23765842,23766610,-,7,1,8,known,chr6:23765842-23766610
sample_6_Aligned.sortedByCoord.out,chr5,29421523,29430808,-,9,1,10,novel,chr5:29421523-29430808
sample_6_Aligned.sortedByCoord.out,chr8,28897573,28899143,-,7,1,8,known,chr8:28897573-28899143
sample_6_Aligned.sortedByCoord.out,chr1,42360896,42364767,+,11,4,15,known,chr1:42360896-42364767
sample_6_Aligned.sortedByCoord.out,chr22,15756697,15761407,+,13,4,17,known,chr22:15756697-15761407
sample_6_Aligned.sortedByCoord.out,chr18,34967527,34975573,+,9,1,10,known,chr18:34967527-34975573
sample_6_Aligned.sortedByCoord.out,chr10,45583316,45585479,+,5,1,6,novel,chr10:45583316-45585479
sample_6_Aligned.sortedByCoord.out,chr1,10499127,10503643,-,18,3,21,known,chr1:10499127-10503643
sample_6_Aligned.sortedByCoord.out,chr2,36674334,36678565,+,7,0,7,known,chr2:36674334-36678565
sample_6_Aligned.sortedByCoord.out,chr5,36471484,36474731,+,13,0,13,known,chr5:36471484-36474731
sample_6_Aligned.sortedByCoord.out,chr20,44814449,44814589,-,12,3,15,known,chr20:44814449-44814589
sample_6_Aligned.sortedByCoord.out,chr3,13177510,13179487,-,11,1,12,known,chr3:13177510-13179487
sample_6_Aligned.sortedByCoord.out,chr19,41741353,41745927,+,8,3,11,novel,chr19:41741353-41745927
sample_6_Aligned.sortedByCoord.out,chr15,22765007,22766819,-,17,0,17,known,chr15:22765007-22766819
sample_6_Aligned.sortedByCoord.out,chr19,13688416,13694285,-,14,2,16,known,chr19:13688416-13694285
sample_6_Aligned.sortedByCoord.out,chr6,44487405,44496749,-,8,0,8,known,chr6:44487405-44496749
sample_6_Aligned.sortedByCoord.out,chr15,47585351,47588630,-,6,1,7,known,chr15:47585351-47588630
sample_6_Aligned.sortedByCoord.out,chr12,20157044,20164884,+,11,1,12,known,chr12:20157044-20164884
sample_6_Aligned.sortedByCoord.out,chr14,4046175,4054702,+,8,5,13,known,chr14:4046175-4054702
sample_6_Aligned.sortedByCoord.out,chr9,25256531,25263408,-,11,2,13,known,chr9:25256531-25263408
sample_6_Aligned.sortedByCoord.out,chr13,19752831,19762824,-,7,2,9,novel,chr13:19752831-19762824
sample_6_Aligned.sortedByCoord.out,chr14,25778866,25781010,+,9,2,11,known,chr14:25778866-25781010
sample_6_Aligned.sortedByCoord.out,chr10,46121631,46127681,+,21,2,23,known,chr10:46121631-46127681
sample_6_Aligned.sortedByCoord.out,chr17,32628006,32630776,+,7,2,9,known,chr17:32628006-32630776
sample_6_Aligned.sortedByCoord.out,chr16,9543286,9546367,+,10,2,12,known,chr16:9543286-9546367
sample_6_Aligned.sortedByCoord.out,chr2,16885359,16889063,-,8,0,8,known,chr2:16885359-16889063
sample_6_Aligned.sortedByCoord.out,chr4,9298056,9300858,-,9,0,9,known,chr4:9298056-9300858
sample_6_Aligned.sortedByCoord.out,chr6,9308048,9312439,-,5,0,5,known,chr6:9308048-9312439
sample_6_Aligned.sortedByCoord.out,chr19,28993380,28994767,+,13,1,14,novel,chr19:28993380-28994767
sample_6_Aligned.sortedByCoord.out,chr22,28892956,28902485,-,8,2,10,known,chr22:28892956-28902485
sample_6_Aligned.sortedByCoord.out,chr16,20200844,20203766,+,13,1,14,known,chr16:20200844-20203766
sample_6_Aligned.sortedByCoord.out,chr14,21493231,21500068,+,11,1,12,novel,chr14:21493231-21500068
sample_6_Aligned.sortedByCoord.out,chr16,21714302,21716629,+,5,4,9,known,chr16:21714302-21716629
sample_6_Aligned.sortedByCoord.out,chr17,37501951,37505468,-,7,2,9,known,chr17:37501951-37505468
sample_6_Aligned.sortedByCoord.out,chr17,34417309,34420102,-,2,2,4,novel,chr17:34417309-34420102
sample_6_Aligned.sortedByCoord.out,chr16,38214221,38217716,-,11,3,14,novel,chr16:38214221-38217716
sample_6_Aligned.sortedByCoord.out,chr12,48033036,48033484,-,18,2,20,novel,chr12:48033036-48033484
sample_6_Aligned.sortedByCoord.out,chr12,24342676,24344167,+,8,1,9,known,chr12:24342676-24344167
sample_6_Aligned.sortedByCoord.out,chr22,40027235,40028972,-,9,1,10,known,chr22:40027235-40028972
sample_6_Aligned.sortedByCoord.out,chr20,17541827,17548561,+,11,1,12,novel,chr20:17541827-17548561
sample_6_Aligned.sortedByCoord.out,chr2,11446670,11451594,-,16,2,18,novel,chr2:11446670-11451594
sample_6_Aligned.sortedByCoord.out,chr18,28296598,28304893,+,6,3,9,known,chr18:28296598-28304893
sample_6_Aligned.sortedByCoord.out,chr21,19185772,19186938,+,20,2,22,known,chr21:19185772-19186938
sample_6_Aligned.sortedByCoord.out,chr1,11646520,11653012,+,8,2,10,known,chr1:11646520-11653012
sample_6_Aligned.sortedByCoord.out,chr20,27443019,27449592,+,13,3,16,known,chr20:27443019-27449592
sample_6_Aligned.sortedByCoord.out,chr5,18076617,18085699,+,16,0,16,known,chr5:18076617-18085699
sample_6_Aligned.sortedByCoord.out,chr7,19735420,19742519,-,14,2,16,known,chr7:19735420-19742519
sample_6_Aligned.sortedByCoord.out,chr19,39750815,39759969,-,6,1,7,known,chr19:39750815-39759969
sample_6_Aligned.sortedByCoord.out,chr15,44622604,44624630,-,7,1,8,novel,chr15:44622604-44624630
sample_6_Aligned.sortedByCoord.out,chr15,11788309,11791132,-,8,0,8,known,chr15:11788309-11791132
sample_6_Aligned.sortedByCoord.out,chr11,6319674,6322211,+,6,3,9,known,chr11:6319674-6322211
sample_6_Aligned.sortedByCoord.out,chr11,3059525,3062744,-,12,1,13,known,chr11:3059525-3062744
sample_6_Aligned.sortedByCoord.out,chr3,42027996,42028143,+,12,1,13,known,chr3:42027996-42028143
sample_6_Aligned.sortedByCoord.out,chr6,25078811,25084557,-,11,0,11,known,chr6:25078811-25084557
sample_6_Aligned.sortedByCoord.out,chr9,26884361,26890012,+,11,1,12,known,chr9:26884361-26890012
sample_6_Aligned.sortedByCoord.out,chr18,32225502,32230285,-,12,2,14,known,chr18:32225502-32230285
sample_6_Aligned.sortedByCoord.out,chr21,33077723,33082461,+,16,1,17,novel,chr21:33077723-33082461
sample_6_Aligned.sortedByCoord.out,chr21,16079941,16086194,+,3,0,3,known,chr21:16079941-16086194
sample_6_Aligned.sortedByCoord.out,chr9,29581779,29590710,-,9,3,12,novel,chr9:29581779-29590710
sample_6_Aligned.sortedByCoord.out,chr16,23754508,23757451,-,8,2,10,known,chr16:23754508-23757451
sample_6_Aligned.sortedByCoord.out,chr20,27551144,27551904,-,10,0,10,known,chr20:27551144-27551904
sample_6_Aligned.sortedByCoord.out,chr6,29425164,29429997,+,8,1,9,novel,chr6:29425164-29429997
sample_6_Aligned.sortedByCoord.out,chr17,4387413,4394624,-,7,0,7,novel,chr17:4387413-4394624
sample_6_Aligned.sortedByCoord.out,chr15,14543483,14546668,-,11,1,12,known,chr15:14543483-14546668
sample_6_Aligned.sortedByCoord.out,chr12,35514704,35521729,+,9,4,13,known,chr12:35514704-35521729
sample_6_Aligned.sortedByCoord.out,chr11,44798786,44801582,-,10,0,10,novel,chr11:44798786-44801582
sample_6_Aligned.sortedByCoord.out,chr4,7046822,7053712,-,14,3,17,known,chr4:7046822-7053712
sample_6_Aligned.sortedByCoord.out,chr9,45042773,45048065,+,10,3,13,known,chr9:45042773-45048065
sample_6_Aligned.sortedByCoord.out,chr7,46710906,46716253,-,10,3,13,known,chr7:46710906-46716253
sample_6_Aligned.sortedByCoord.out,chr5,31952472,31960791,+,9,2,11,novel,chr5:31952472-31960791
sample_6_Aligned.sortedByCoord.out,chr11,2806349,2810367,+,12,3,15,novel,chr11:2806349-2810367
sample_6_Aligned.sortedByCoord.out,chr8,29692549,29701940,-,12,0,12,known,chr8:29692549-29701940
sample_6_Aligned.sortedByCoord.out,chr20,16933728,16939571,-,9,1,10,known,chr20:16933728-16939571
sample_6_Aligned.sortedByCoord.out,chr22,49213853,49221164,-,10,2,12,known,chr22:49213853-49221164
sample_6_Aligned.sortedByCoord.out,chr17,20485682,20490532,-,9,5,14,novel,chr17:20485682-20490532
sample_6_Aligned.sortedByCoord.out,chr11,37786902,37796140,-,10,1,11,known,chr11:37786902-37796140
sample_6_Aligned.sortedByCoord.out,chr17,13020653,13028143,+,18,2,20,known,chr17:13020653-13028143
sample_6_Aligned.sortedByCoord.out,chr4,24075077,24078798,-,17,1,18,known,chr4:24075077-24078798
sample_6_Aligned.sortedByCoord.out,chr19,48914484,48921863,+,5,2,7,known,chr19:48914484-48921863
sample_6_Aligned.sortedByCoord.out,chr8,38184846,38186763,+,12,3,15,known,chr8:38184846-38186763
sample_6_Aligned.sortedByCoord.out,chr12,5141087,5143849,+,8,3,11,known,chr12:5141087-5143849
sample_6_Aligned.sortedByCoord.out,chr18,33346415,33349244,-,9,2,11,known,chr18:33346415-33349244
sample_6_Aligned.sortedByCoord.out,chr18,1849941,1859629,-,11,1,12,known,chr18:1849941-1859629
sample_6_Aligned.sortedByCoord.out,chr13,40867551,40876659,-,8,3,11,known,chr13:40867551-40876659
sample_6_Aligned.sortedByCoord.out,chr17,4207357,4209386,+,7,0,7,known,chr17:4207357-4209386
sample_6_Aligned.sortedByCoord.out,chr22,11561201,11566550,-,12,3,15,known,chr22:11561201-11566550
sample_6_Aligned.sortedByCoord.out,chr16,17533024,17536940,-,12,0,12,known,chr16:17533024-17536940
sample_6_Aligned.sortedByCoord.out,chr2,39329243,39336525,-,12,3,15,known,chr2:39329243-39336525
sample_6_Aligned.sortedByCoord.out,chr16,49373121,49378037,+,11,1,12,novel,chr16:49373121-49378037
sample_6_Aligned.sortedByCoord.out,chr10,43652340,43654481,+,14,0,14,known,chr10:43652340-43654481
sample_6_Aligned.sortedByCoord.out,chr10,26950379,26951083,+,5,2,7,known,chr10:26950379-26951083
sample_6_Aligned.sortedByCoord.out,chr22,45701516,45707272,+,8,3,11,known,chr22:45701516-45707272
sample_6_Aligned.sortedByCoord.out,chr19,28848446,28858003,-,10,3,13,known,chr19:28848446-28858003
sample_6_Aligned.sortedByCoord.out,chr5,19854519,19858376,+,13,0,13,known,chr5:19854519-19858376
sample_6_Aligned.sortedByCoord.out,chr17,29637861,29642810,+,11,1,12,known,chr17:29637861-29642810
sample_6_Aligned.sortedByCoord.out,chr8,46233598,46238670,-,14,4,18,known,chr8:46233598-46238670
sample_6_Aligned.sortedByCoord.out,chr13,27313620,27317151,-,4,2,6,known,chr13:27313620-27317151
sample_6_Aligned.sortedByCoord.out,chr19,27898505,27905415,-,10,0,10,known,chr19:27898505-27905415
sample_6_Aligned.sortedByCoord.out,chr14,26299763,26300731,+,7,3,10,known,chr14:26299763-26300731
sample_6_Aligned.sortedByCoord.out,chr9,36767623,36767805,-,8,0,8,novel,chr9:36767623-36767805
sample_6_Aligned.sortedByCoord.out,chr18,21614206,21623586,-,5,1,6,known,chr18:21614206-21623586
sample_6_Aligned.sortedByCoord.out,chr17,30053836,30062880,+,10,0,10,known,chr17:30053836-30062880
sample_6_Aligned.sortedByCoord.out,chr21,11618224,11622131,-,11,3,14,known,chr21:11618224-11622131
sample_6_Aligned.sortedByCoord.out,chr6,6017409,6018403,-,3,1,4,novel,chr6:6017409-6018403
sample_6_Aligned.sortedByCoord.out,chr3,33162913,33166679,-,6,3,9,novel,chr3:33162913-33166679
sample_6_Aligned.sortedByCoord.out,chr3,14670346,14672558,-,9,0,9,known,chr3:14670346-14672558
sample_6_Aligned.sortedByCoord.out,chr4,39730701,39734352,+,8,0,8,novel,chr4:39730701-39734352
sample_6_Aligned.sortedByCoord.out,chr21,5048767,5057212,+,16,0,16,known,chr21:5048767-5057212
sample_6_Aligned.sortedByCoord.out,chr18,36513716,36515932,-,8,0,8,known,chr18:36513716-36515932
sample_6_Aligned.sortedByCoord.out,chr16,21597371,21600212,+,15,3,18,known,chr16:21597371-21600212
sample_6_Aligned.sortedByCoord.out,chr9,29138697,29142388,+,9,2,11,known,chr9:29138697-29142388
sample_6_Aligned.sortedByCoord.out,chr2,5820155,5823425,+,12,1,13,known,chr2:5820155-5823425
sample_6_Aligned.sortedByCoord.out,chr2,36975329,36977968,-,11,1,12,known,chr2:36975329-36977968
sample_6_Aligned.sortedByCoord.out,chr7,34134563,34135981,+,7,0,7,known,chr7:34134563-34135981
sample_6_Aligned.sortedByCoord.out,chr5,41172318,41181332,-,6,4,10,known,chr5:41172318-41181332
sample_6_Aligned.sortedByCoord.out,chr16,12445321,12452099,+,6,3,9,known,chr16:12445321-12452099
sample_6_Aligned.sortedByCoord.out,chr16,19338804,19348287,+,9,0,9,known,chr16:19338804-19348287
sample_6_Aligned.sortedByCoord.out,chr1,22501870,22509566,+,11,0,11,known,chr1:22501870-22509566
sample_6_Aligned.sortedByCoord.out,chr6,23726903,23727959,-,15,3,18,novel,chr6:23726903-23727959
sample_6_Aligned.sortedByCoord.out,chr17,9879928,9880635,-,14,2,16,known,chr17:9879928-9880635
sample_6_Aligned.sortedByCoord.out,chr4,6472717,6475271,+,4,3,7,known,chr4:6472717-6475271
sample_6_Aligned.sortedByCoord.out,chr14,49337731,49341812,-,7,4,11,novel,chr14:49337731-49341812
sample_6_Aligned.sortedByCoord.out,chr17,34802942,34808915,+,11,2,13,known,chr17:34802942-34808915
sample_6_Aligned.sortedByCoord.out,chr4,25111806,25115546,-,10,0,10,novel,chr4:25111806-25115546
sample_6_Aligned.sortedByCoord.out,chr15,4276494,4284655,+,9,3,12,known,chr15:4276494-4284655
sample_6_Aligned.sortedByCoord.out,chr19,14770095,14770665,-,8,2,10,novel,chr19:14770095-14770665
sample_6_Aligned.sortedByCoord.out,chr16,22822036,22824382,-,16,1,17,known,chr16:22822036-22824382
sample_6_Aligned.sortedByCoord.out,chr6,17339076,17348107,-,11,0,11,known,chr6:17339076-17348107
sample_6_Aligned.sortedByCoord.out,chr18,37389497,37392394,+,12,1,13,known,chr18:37389497-37392394
sample_6_Aligned.sortedByCoord.out,chr21,49485387,49490599,-,10,2,12,known,chr21:49485387-49490599
sample_6_Aligned.sortedByCoord.out,chr4,41545162,41547210,+,16,3,19,known,chr4:41545162-41547210
sample_6_Aligned.sortedByCoord.out,chr12,2095166,2095977,+,16,2,18,known,chr12:2095166-2095977
sample_6_Aligned.sortedByCoord.out,chr18,49048314,49048500,+,13,1,14,known,chr18:49048314-49048500
sample_6_Aligned.sortedByCoord.out,chr22,7870060,7873059,+,12,5,17,known,chr22:7870060-7873059
sample_6_Aligned.sortedByCoord.out,chr4,27239131,27239768,-,11,4,15,novel,chr4:27239131-27239768
sample_6_Aligned.sortedByCoord.out,chr6,42535006,42544333,-,4,3,7,known,chr6:42535006-42544333
sample_6_Aligned.sortedByCoord.out,chr6,32528015,32531197,+,12,1,13,known,chr6:32528015-32531197
sample_6_Aligned.sortedByCoord.out,chr3,32018835,32021063,-,10,1,11,known,chr3:32018835-32021063
sample_6_Aligned.sortedByCoord.out,chr21,9086405,9094395,-,14,2,16,known,chr21:9086405-9094395
sample_6_Aligned.sortedByCoord.out,chr1,37221702,37225062,+,9,1,10,known,chr1:37221702-37225062
sample_6_Aligned.sortedByCoord.out,chr4,42986024,42994292,-,7,0,7,known,chr4:42986024-42994292
sample_6_Aligned.sortedByCoord.out,chr6,30898069,30898938,-,7,5,12,known,chr6:30898069-30898938
sample_6_Aligned.sortedByCoord.out,chr13,28401154,28408898,-,7,1,8,known,chr13:28401154-28408898
sample_6_Aligned.sortedByCoord.out,chr12,27084446,27087841,-,13,3,16,known,chr12:27084446-27087841
sample_6_Aligned.sortedByCoord.out,chr22,30420641,30428370,+,11,3,14,known,chr22:30420641-30428370
sample_6_Aligned.sortedByCoord.out,chr9,14625305,14627189,+,6,2,8,known,chr9:14625305-14627189
sample_6_Aligned.sortedByCoord.out,chr14,7415277,7418007,-,8,1,9,known,chr14:7415277-7418007
sample_6_Aligned.sortedByCoord.out,chr22,40805440,40806687,+,10,4,14,known,chr22:40805440-40806687
sample_6_Aligned.sortedByCoord.out,chr22,27443629,27446512,+,5,3,8,known,chr22:27443629-27446512
sample_6_Aligned.sortedByCoord.out,chr17,22828432,22830590,+,8,4,12,known,chr17:22828432-22830590
sample_6_Aligned.sortedByCoord.out,chr6,8483106,8483664,+,9,3,12,known,chr6:8483106-8483664
sample_6_Aligned.sortedByCoord.out,chr10,32114809,32119799,+,5,4,9,known,chr10:32114809-32119799
sample_6_Aligned.sortedByCoord.out,chr18,34913045,34921163,-,9,1,10,novel,chr18:34913045-34921163
sample_6_Aligned.sortedByCoord.out,chr5,23309589,23312947,+,15,3,18,known,chr5:23309589-23312947
sample_6_Aligned.sortedByCoord.out,chr18,13376872,13377476,+,10,3,13,known,chr18:13376872-13377476
sample_6_Aligned.sortedByCoord.out,chr2,36835069,36840881,-,6,3,9,known,chr2:36835069-36840881
sample_6_Aligned.sortedByCoord.out,chr3,4364979,4366724,-,4,2,6,known,chr3:4364979-4366724
sample_6_Aligned.sortedByCoord.out,chr17,30350214,30354534,+,10,2,12,known,chr17:30350214-30354534
sample_6_Aligned.sortedByCoord.out,chr15,5232301,5236450,+,12,1,13,known,chr15:5232301-5236450
sample_6_Aligned.sortedByCoord.out,chr3,29959449,29960842,+,10,3,13,known,chr3:29959449-29960842
sample_6_Aligned.sortedByCoord.out,chr8,7085036,7086084,-,16,3,19,novel,chr8:7085036-7086084
sample_6_Aligned.sortedByCoord.out,chr17,8584696,8594680,-,4,1,5,novel,chr17:8584696-8594680
sample_6_Aligned.sortedByCoord.out,chr2,18512137,18519614,+,8,3,11,known,chr2:18512137-18519614
sample_6_Aligned.sortedByCoord.out,chr22,3353995,3360416,+,17,0,17,known,chr22:3353995-3360416
sample_6_Aligned.sortedByCoord.out,chr13,23446537,23447602,-,9,4,13,known,chr13:23446537-23447602
sample_6_Aligned.sortedByCoord.out,chr12,14300832,14305845,-,13,1,14,novel,chr12:14300832-14305845
sample_6_Aligned.sortedByCoord.out,chr7,23392380,23392815,-,9,4,13,novel,chr7:23392380-23392815
sample_6_Aligned.sortedByCoord.out,chr17,14378830,14386213,-,11,5,16,novel,chr17:14378830-14386213
sample_6_Aligned.sortedByCoord.out,chr1,17872463,17879349,+,5,0,5,known,chr1:17872463-17879349
sample_6_Aligned.sortedByCoord.out,chr3,43913201,43920672,+,13,1,14,known,chr3:43913201-43920672
sample_6_Aligned.sortedByCoord.out,chr11,29085356,29090378,+,8,1,9,novel,chr11:29085356-29090378
sample_6_Aligned.sortedByCoord.out,chr15,13357021,13365053,-,11,1,12,novel,chr15:13357021-13365053
sample_6_Aligned.sortedByCoord.out,chr8,15392100,15400573,-,14,4,18,known,chr8:15392100-15400573
sample_6_Aligned.sortedByCoord.out,chr14,2501655,2506419,+,9,3,12,known,chr14:2501655-2506419
sample_6_Aligned.sortedByCoord.out,chr4,34361341,34366004,-,13,3,16,known,chr4:34361341-34366004
sample_6_Aligned.sortedByCoord.out,chr19,21868071,21868539,+,3,1,4,novel,chr19:21868071-21868539
sample_6_Aligned.sortedByCoord.out,chr12,36819887,36823588,+,7,2,9,known,chr12:36819887-36823588
sample_6_Aligned.sortedByCoord.out,chr17,32050874,32059939,-,7,2,9,known,chr17:32050874-32059939
sample_6_Aligned.sortedByCoord.out,chr3,46763758,46768557,+,10,1,11,known,chr3:46763758-46768557
sample_6_Aligned.sortedByCoord.out,chr11,26913195,26914886,+,13,5,18,known,chr11:26913195-26914886
sample_6_Aligned.sortedByCoord.out,chr8,39151387,39157505,-,15,2,17,known,chr8:39151387-39157505
sample_6_Aligned.sortedByCoord.out,chr6,31092135,31097304,+,6,2,8,known,chr6:31092135-31097304
sample_6_Aligned.sortedByCoord.out,chr2,35942101,35945697,+,13,2,15,known,chr2:35942101-35945697
sample_6_Aligned.sortedByCoord.out,chr8,22721908,22729516,+,10,1,11,known,chr8:22721908-22729516
sample_6_Aligned.sortedByCoord.out,chr21,16358597,16362688,-,6,5,11,known,chr21:16358597-16362688
sample_6_Aligned.sortedByCoord.out,chr7,46552357,46552888,-,2,0,2,known,chr7:46552357-46552888
sample_6_Aligned.sortedByCoord.out,chr13,18580782,18583570,-,12,2,14,known,chr13:18580782-18583570
sample_6_Aligned.sortedByCoord.out,chr21,24011230,24018215,+,14,1,15,known,chr21:24011230-24018215
sample_6_Aligned.sortedByCoord.out,chr16,41578228,41580550,+,6,3,9,known,chr16:41578228-41580550
sample_6_Aligned.sortedByCoord.out,chr3,49207989,49211168,-,11,3,14,known,chr3:49207989-49211168
sample_6_Aligned.sortedByCoord.out,chr6,21572997,21582765,+,13,1,14,known,chr6:21572997-21582765
sample_6_Aligned.sortedByCoord.out,chr5,11395932,11399420,-,8,1,9,known,chr5:11395932-11399420
sample_6_Aligned.sortedByCoord.out,chr7,24838240,24838676,-,15,2,17,known,chr7:24838240-24838676
sample_6_Aligned.sortedByCoord.out,chr10,23961708,23970558,+,6,0,6,known,chr10:23961708-23970558
sample_6_Aligned.sortedByCoord.out,chr15,12124175,12130777,+,8,1,9,novel,chr15:12124175-12130777
sample_6_Aligned.sortedByCoord.out,chr8,26725248,26733612,-,11,1,12,known,chr8:26725248-26733612
sample_6_Aligned.sortedByCoord.out,chr15,36629403,36632150,+,13,1,14,known,chr15:36629403-36632150
sample_6_Aligned.sortedByCoord.out,chr9,17945164,17950975,-,10,4,14,known,chr9:17945164-17950975
sample_6_Aligned.sortedByCoord.out,chr14,28487915,28496665,-,12,2,14,novel,chr14:28487915-28496665
sample_6_Aligned.sortedByCoord.out,chr9,11818724,11821786,+,7,1,8,known,chr9:11818724-11821786
sample_6_Aligned.sortedByCoord.out,chr4,12180436,12188980,+,2,3,5,known,chr4:12180436-12188980
sample_6_Aligned.sortedByCoord.out,chr16,44596151,44599917,+,12,1,13,novel,chr16:44596151-44599917
sample_6_Aligned.sortedByCoord.out,chr14,12196378,12206077,+,10,2,12,known,chr14:12196378-12206077
sample_6_Aligned.sortedByCoord.out,chr9,24763447,24768617,-,7,5,12,known,chr9:24763447-24768617
sample_6_Aligned.sortedByCoord.out,chr13,48170059,48171041,-,7,0,7,known,chr13:48170059-48171041
sample_6_Aligned.sortedByCoord.out,chr15,25188331,25188877,-,9,0,9,known,chr15:25188331-25188877
sample_6_Aligned.sortedByCoord.out,chr2,38745705,38749931,+,11,2,13,known,chr2:38745705-38749931
sample_6_Aligned.sortedByCoord.out,chr2,24375721,24379478,-,7,1,8,known,chr2:24375721-24379478
sample_6_Aligned.sortedByCoord.out,chr14,16611074,16616983,+,6,1,7,known,chr14:16611074-16616983
sample_6_Aligned.sortedByCoord.out,chr18,31669856,31678258,-,11,3,14,known,chr18:31669856-31678258
sample_6_Aligned.sortedByCoord.out,chr1,21694724,21701929,+,8,1,9,known,chr1:21694724-21701929
sample_6_Aligned.sortedByCoord.out,chr21,11795821,11798990,+,12,0,12,known,chr21:11795821-11798990
sample_6_Aligned.sortedByCoord.out,chr7,29388389,29392143,-,14,2,16,known,chr7:29388389-29392143
sample_6_Aligned.sortedByCoord.out,chr19,1849115,1853912,-,6,5,11,novel,chr19:1849115-1853912
sample_6_Aligned.sortedByCoord.out,chr18,24474198,24480048,+,8,2,10,known,chr18:24474198-24480048
sample_6_Aligned.sortedByCoord.out,chr19,45965838,45971404,+,6,4,10,novel,chr19:45965838-45971404
sample_6_Aligned.sortedByCoord.out,chr22,26589848,26595437,+,12,1,13,known,chr22:26589848-26595437
sample_6_Aligned.sortedByCoord.out,chr18,45723952,45729481,-,10,2,12,known,chr18:45723952-45729481
sample_6_Aligned.sortedByCoord.out,chr21,19826531,19832051,+,9,3,12,known,chr21:19826531-19832051
sample_6_Aligned.sortedByCoord.out,chr16,46261798,46263001,-,14,1,15,novel,chr16:46261798-46263001
sample_6_Aligned.sortedByCoord.out,chr1,45734864,45742959,+,12,3,15,known,chr1:45734864-45742959
sample_6_Aligned.sortedByCoord.out,chr20,5524824,5528048,-,7,2,9,known,chr20:5524824-5528048
sample_6_Aligned.sortedByCoord.out,chr17,41046323,41055130,-,12,5,17,novel,chr17:41046323-41055130
sample_6_Aligned.sortedByCoord.out,chr20,1979548,1983538,-,7,5,12,novel,chr20:1979548-1983538
sample_6_Aligned.sortedByCoord.out,chr7,43010392,43014444,-,11,0,11,known,chr7:43010392-43014444
sample_6_Aligned.sortedByCoord.out,chr8,42649664,42656172,+,9,0,9,known,chr8:42649664-42656172
sample_6_Aligned.sortedByCoord.out,chr15,5309154,5316415,-,6,0,6,novel,chr15:5309154-5316415
sample_6_Aligned.sortedByCoord.out,chr21,42491056,42493772,-,12,2,14,novel,chr21:42491056-42493772
sample_6_Aligned.sortedByCoord.out,chr8,21856129,21863252,-,7,3,10,novel,chr8:21856129-21863252
sample_6_Aligned.sortedByCoord.out,chr9,19573882,19580704,-,14,2,16,known,chr9:19573882-19580704
sample_6_Aligned.sortedByCoord.out,chr18,17906360,17909198,+,10,4,14,known,chr18:17906360-17909198
sample_6_Aligned.sortedByCoord.out,chr9,10109013,10111787,-,13,1,14,known,chr9:10109013-10111787
sample_6_Aligned.sortedByCoord.out,chr11,26665586,26670071,+,8,3,11,known,chr11:26665586-26670071
sample_6_Aligned.sortedByCoord.out,chr4,20842216,20847871,-,13,4,17,known,chr4:20842216-20847871
sample_6_Aligned.sortedByCoord.out,chr4,6150122,6156711,-,11,1,12,known,chr4:6150122-6156711
sample_6_Aligned.sortedByCoord.out,chr6,41471984,41477709,+,11,4,15,known,chr6:41471984-41477709
sample_6_Aligned.sortedByCoord.out,chr17,24670861,24673175,-,12,4,16,novel,chr17:24670861-24673175
sample_6_Aligned.sortedByCoord.out,chr15,40131799,40133976,-,13,2,15,novel,chr15:40131799-40133976
sample_6_Aligned.sortedByCoord.out,chr8,38106923,38111404,+,18,5,23,known,chr8:38106923-38111404
sample_6_Aligned.sortedByCoord.out,chr20,33462695,33465615,-,9,1,10,known,chr20:33462695-33465615
sample_6_Aligned.sortedByCoord.out,chr4,9671776,9675591,-,15,1,16,known,chr4:9671776-9675591
sample_6_Aligned.sortedByCoord.out,chr4,38425090,38433434,+,11,4,15,known,chr4:38425090-38433434
sample_6_Aligned.sortedByCoord.out,chr5,30636966,30643009,+,12,3,15,known,chr5:30636966-30643009
sample_6_Aligned.sortedByCoord.out,chr11,9108133,9117007,-,8,3,11,known,chr11:9108133-9117007
sample_6_Aligned.sortedByCoord.out,chr12,24631188,24632704,-,11,6,17,known,chr12:24631188-24632704
sample_6_Aligned.sortedByCoord.out,chr7,10659289,10663886,-,7,3,10,known,chr7:10659289-10663886
sample_6_Aligned.sortedByCoord.out,chr11,12772570,12776888,+,10,4,14,known,chr11:12772570-12776888
sample_6_Aligned.sortedByCoord.out,chr10,13099476,13106153,+,9,3,12,known,chr10:13099476-13106153
sample_6_Aligned.sortedByCoord.out,chr10,26111656,26117008,-,7,5,12,known,chr10:26111656-26117008
sample_6_Aligned.sortedByCoord.out,chr2,28242738,28245183,+,12,2,14,known,chr2:28242738-28245183
sample_6_Aligned.sortedByCoord.out,chr19,34685584,34686013,-,11,2,13,known,chr19:34685584-34686013
sample_6_Aligned.sortedByCoord.out,chr15,27156555,27162027,-,6,3,9,known,chr15:27156555-27162027
sample_6_Aligned.sortedByCoord.out,chr8,43840954,43846837,-,7,1,8,known,chr8:43840954-43846837
sample_6_Aligned.sortedByCoord.out,chr5,34317515,34324338,+,11,0,11,known,chr5:34317515-34324338
sample_6_Aligned.sortedByCoord.out,chr17,6386570,6391719,+,10,0,10,known,chr17:6386570-6391719
sample_6_Aligned.sortedByCoord.out,chr8,3544573,3546712,-,7,1,8,known,chr8:3544573-3546712
sample_6_Aligned.sortedByCoord.out,chr3,24123045,24125707,+,14,0,14,known,chr3:24123045-24125707
sample_6_Aligned.sortedByCoord.out,chr17,31357226,31357739,-,7,1,8,novel,chr17:31357226-31357739
sample_6_Aligned.sortedByCoord.out,chr21,32340939,32346351,-,13,2,15,known,chr21:32340939-32346351
sample_6_Aligned.sortedByCoord.out,chr15,30890918,30900426,-,11,0,11,known,chr15:30890918-30900426
sample_6_Aligned.sortedByCoord.out,chr22,24405270,24405562,-,14,0,14,known,chr22:24405270-24405562
sample_6_Aligned.sortedByCoord.out,chr12,37394619,37400574,-,14,0,14,known,chr12:37394619-37400574
sample_6_Aligned.sortedByCoord.out,chr8,35823747,35825044,+,6,3,9,known,chr8:35823747-35825044
sample_6_Aligned.sortedByCoord.out,chr13,36815177,36817393,-,10,2,12,known,chr13:36815177-36817393
sample_6_Aligned.sortedByCoord.out,chr15,44198009,44206853,+,20,4,24,known,chr15:44198009-44206853
sample_6_Aligned.sortedByCoord.out,chr22,11636505,11645990,+,8,1,9,known,chr22:11636505-11645990
sample_6_Aligned.sortedByCoord.out,chr21,22531423,22541056,+,8,2,10,known,chr21:22531423-22541056
sample_6_Aligned.sortedByCoord.out,chr4,15243814,15252293,-,9,4,13,known,chr4:15243814-15252293
sample_6_Aligned.sortedByCoord.out,chr8,47315054,47318104,-,11,2,13,known,chr8:47315054-47318104
sample_6_Aligned.sortedByCoord.out,chr17,23100409,23110364,+,5,3,8,known,chr17:23100409-23110364
sample_6_Aligned.sortedByCoord.out,chr7,20418952,20426924,-,6,2,8,known,chr7:20418952-20426924
sample_6_Aligned.sortedByCoord.out,chr12,18119024,18119154,+,10,2,12,novel,chr12:18119024-18119154
sample_6_Aligned.sortedByCoord.out,chr12,34366603,34371465,-,7,2,9,known,chr12:34366603-34371465
sample_6_Aligned.sortedByCoord.out,chr16,22393126,22396632,-,5,4,9,known,chr16:22393126-22396632
sample_6_Aligned.sortedByCoord.out,chr21,26465093,26474865,+,8,2,10,novel,chr21:26465093-26474865
sample_6_Aligned.sortedByCoord.out,chr15,2683963,2687005,+,8,3,11,novel,chr15:2683963-2687005
sample_6_Aligned.sortedByCoord.out,chr22,26480048,26487736,+,12,2,14,known,chr22:26480048-26487736
sample_6_Aligned.sortedByCoord.out,chr7,43681464,43685998,+,13,1,14,known,chr7:43681464-43685998
sample_6_Aligned.sortedByCoord.out,chr5,4074986,4082100,-,6,2,8,known,chr5:4074986-4082100
sample_6_Aligned.sortedByCoord.out,chr12,17044362,17046720,-,15,3,18,known,chr12:17044362-17046720
sample_6_Aligned.sortedByCoord.out,chr6,15776763,15786479,-,8,1,9,known,chr6:15776763-15786479
sample_6_Aligned.sortedByCoord.out,chr19,20545051,20552026,+,7,1,8,known,chr19:20545051-20552026
sample_6_Aligned.sortedByCoord.out,chr22,25687432,25692401,+,10,3,13,known,chr22:25687432-25692401
sample_6_Aligned.sortedByCoord.out,chr16,34896829,34904413,-,13,3,16,known,chr16:34896829-34904413
sample_6_Aligned.sortedByCoord.out,chr1,43505614,43508751,+,5,0,5,known,chr1:43505614-43508751
sample_6_Aligned.sortedByCoord.out,chr4,44852377,44860592,-,9,3,12,known,chr4:44852377-44860592
sample_6_Aligned.sortedByCoord.out,chr12,4872797,4875453,-,16,4,20,known,chr12:4872797-4875453
sample_6_Aligned.sortedByCoord.out,chr17,37980951,37982417,+,7,5,12,novel,chr17:37980951-37982417
sample_6_Aligned.sortedByCoord.out,chr2,47416392,47425629,+,4,4,8,known,chr2:47416392-47425629
sample_6_Aligned.sortedByCoord.out,chr17,41517563,41522937,-,10,3,13,known,chr17:41517563-41522937
sample_6_Aligned.sortedByCoord.out,chr5,5638159,5641001,-,7,1,8,known,chr5:5638159-5641001
sample_6_Aligned.sortedByCoord.out,chr2,20484329,20485419,+,6,3,9,known,chr2:20484329-20485419
sample_6_Aligned.sortedByCoord.out,chr2,16915101,16915856,-,14,1,15,known,chr2:16915101-16915856
sample_6_Aligned.sortedByCoord.out,chr19,27267052,27268158,+,9,1,10,novel,chr19:27267052-27268158
sample_6_Aligned.sortedByCoord.out,chr3,7012772,7014886,+,9,5,14,known,chr3:7012772-7014886
sample_6_Aligned.sortedByCoord.out,chr1,28276040,28277376,-,5,2,7,known,chr1:28276040-28277376
sample_6_Aligned.sortedByCoord.out,chr3,42362476,42363241,+,11,2,13,known,chr3:42362476-42363241
sample_6_Aligned.sortedByCoord.out,chr17,13093720,13094793,-,10,2,12,known,chr17:13093720-13094793
sample_6_Aligned.sortedByCoord.out,chr5,16340614,16341599,+,18,0,18,known,chr5:16340614-16341599
sample_6_Aligned.sortedByCoord.out,chr13,12117744,12118325,+,11,1,12,known,chr13:12117744-12118325
sample_6_Aligned.sortedByCoord.out,chr20,3118145,3128030,+,7,2,9,known,chr20:3118145-3128030
sample_6_Aligned.sortedByCoord.out,chr5,2421763,2424057,+,7,2,9,known,chr5:2421763-2424057
sample_6_Aligned.sortedByCoord.out,chr4,19919529,19922106,+,6,1,7,known,chr4:19919529-19922106
sample_6_Aligned.sortedByCoord.out,chr2,18280680,18289750,-,14,1,15,known,chr2:18280680-18289750
sample_6_Aligned.sortedByCoord.out,chr17,39670770,39678847,-,12,1,13,known,chr17:39670770-39678847
sample_6_Aligned.sortedByCoord.out,chr5,21547589,21549313,+,11,1,12,known,chr5:21547589-21549313
sample_6_Aligned.sortedByCoord.out,chr17,10457158,10462054,+,15,2,17,known,chr17:10457158-10462054
sample_6_Aligned.sortedByCoord.out,chr14,16634042,16635242,+,6,7,13,known,chr14:16634042-16635242
sample_6_Aligned.sortedByCoord.out,chr11,21888120,21897642,-,12,2,14,known,chr11:21888120-21897642
sample_6_Aligned.sortedByCoord.out,chr1,29718042,29724708,+,8,2,10,novel,chr1:29718042-29724708
sample_6_Aligned.sortedByCoord.out,chr10,12685782,12690559,-,6,3,9,known,chr10:12685782-12690559
sample_6_Aligned.sortedByCoord.out,chr6,3198412,3205303,+,13,2,15,known,chr6:3198412-3205303
sample_6_Aligned.sortedByCoord.out,chr22,26093011,26098488,-,9,4,13,novel,chr22:26093011-26098488
sample_6_Aligned.sortedByCoord.out,chr19,35186517,35191444,-,6,0,6,known,chr19:35186517-35191444
sample_6_Aligned.sortedByCoord.out,chr10,1256330,1258986,-,10,3,13,novel,chr10:1256330-1258986
sample_6_Aligned.sortedByCoord.out,chr2,9457029,9465553,-,6,0,6,known,chr2:9457029-9465553
sample_6_Aligned.sortedByCoord.out,chr12,20746642,20747094,+,17,1,18,known,chr12:20746642-20747094
sample_6_Aligned.sortedByCoord.out,chr17,42074867,42082316,-,12,3,15,known,chr17:42074867-42082316
sample_6_Aligned.sortedByCoord.out,chr4,10600846,10603719,+,13,0,13,known,chr4:10600846-10603719
sample_6_Aligned.sortedByCoord.out,chr1,48462818,48468598,+,7,0,7,known,chr1:48462818-48468598
sample_6_Aligned.sortedByCoord.out,chr17,28480457,28483717,+,8,0,8,known,chr17:28480457-28483717
sample_6_Aligned.sortedByCoord.out,chr9,1141443,1150071,-,4,1,5,known,chr9:1141443-1150071
sample_6_Aligned.sortedByCoord.out,chr21,1824633,1826612,-,8,2,10,known,chr21:1824633-1826612
sample_6_Aligned.sortedByCoord.out,chr22,34061638,34066698,-,13,0,13,known,chr22:34061638-34066698
sample_6_Aligned.sortedByCoord.out,chr16,2105982,2110639,+,15,4,19,novel,chr16:2105982-2110639
sample_6_Aligned.sortedByCoord.out,chr8,31821305,31821466,-,8,2,10,known,chr8:31821305-31821466
sample_6_Aligned.sortedByCoord.out,chr3,32110306,32119036,+,12,1,13,novel,chr3:32110306-32119036
sample_6_Aligned.sortedByCoord.out,chr11,27254716,27255326,+,14,3,17,known,chr11:27254716-27255326
sample_6_Aligned.sortedByCoord.out,chr12,43179134,43182888,+,10,1,11,known,chr12:43179134-43182888
sample_6_Aligned.sortedByCoord.out,chr15,2654919,2656093,-,17,4,21,known,chr15:2654919-2656093
sample_6_Aligned.sortedByCoord.out,chr8,24161018,24166355,-,9,2,11,known,chr8:24161018-24166355
sample_6_Aligned.sortedByCoord.out,chr18,13965468,13974062,+,7,1,8,known,chr18:13965468-13974062
sample_6_Aligned.sortedByCoord.out,chr7,3315581,3319293,+,11,2,13,known,chr7:3315581-3319293
sample_6_Aligned.sortedByCoord.out,chr14,49862860,49869714,+,6,2,8,novel,chr14:49862860-49869714
sample_6_Aligned.sortedByCoord.out,chr20,8335583,8344052,+,11,2,13,known,chr20:8335583-8344052
sample_6_Aligned.sortedByCoord.out,chr6,25242843,25250907,+,10,4,14,known,chr6:25242843-25250907
sample_6_Aligned.sortedByCoord.out,chr18,28972062,28976692,-,10,0,10,novel,chr18:28972062-28976692
sample_6_Aligned.sortedByCoord.out,chr13,11202551,11209620,+,16,3,19,known,chr13:11202551-11209620
sample_6_Aligned.sortedByCoord.out,chr19,15686562,15690680,-,10,3,13,known,chr19:15686562-15690680
sample_6_Aligned.sortedByCoord.out,chr21,17922134,17930381,-,9,4,13,novel,chr21:17922134-17930381
sample_6_Aligned.sortedByCoord.out,chr21,17036097,17040233,+,19,3,22,known,chr21:17036097-17040233
sample_6_Aligned.sortedByCoord.out,chr5,32948007,32953798,-,7,3,10,novel,chr5:32948007-32953798
sample_6_Aligned.sortedByCoord.out,chr19,21214801,21217126,+,8,2,10,known,chr19:21214801-21217126
sample_6_Aligned.sortedByCoord.out,chr8,18795312,18800700,-,9,1,10,known,chr8:18795312-18800700
sample_6_Aligned.sortedByCoord.out,chr16,9524229,9525345,-,11,2,13,known,chr16:9524229-9525345
sample_6_Aligned.sortedByCoord.out,chr12,13062816,13067425,+,10,4,14,novel,chr12:13062816-13067425
sample_6_Aligned.sortedByCoord.out,chr12,39028193,39035127,+,13,3,16,known,chr12:39028193-39035127
sample_6_Aligned.sortedByCoord.out,chr14,48052559,48056030,-,10,4,14,known,chr14:48052559-48056030
sample_6_Aligned.sortedByCoord.out,chr2,23995739,23996520,+,12,1,13,known,chr2:23995739-23996520
sample_6_Aligned.sortedByCoord.out,chr14,2070386,2076753,-,7,4,11,known,chr14:2070386-2076753
sample_6_Aligned.sortedByCoord.out,chr17,31282005,31285988,+,8,5,13,known,chr17:31282005-31285988
sample_6_Aligned.sortedByCoord.out,chr14,36693582,36694627,+,9,5,14,known,chr14:36693582-36694627
sample_6_Aligned.sortedByCoord.out,chr12,41630862,41636490,-,12,0,12,known,chr12:41630862-41636490
sample_6_Aligned.sortedByCoord.out,chr8,48290704,48296890,-,9,2,11,known,chr8:48290704-48296890
sample_6_Aligned.sortedByCoord.out,chr15,20695030,20699110,+,8,1,9,known,chr15:20695030-20699110
sample_6_Aligned.sortedByCoord.out,chr16,42668068,42671642,-,8,3,11,known,chr16:42668068-42671642
sample_6_Aligned.sortedByCoord.out,chr16,33358304,33363483,-,13,1,14,known,chr16:33358304-33363483
sample_6_Aligned.sortedByCoord.out,chr7,3860354,3869305,+,6,2,8,known,chr7:3860354-3869305
sample_6_Aligned.sortedByCoord.out,chr11,15445103,15446429,+,9,7,16,known,chr11:15445103-15446429
sample_6_Aligned.sortedByCoord.out,chr14,22189305,22195396,+,11,3,14,known,chr14:22189305-22195396
sample_6_Aligned.sortedByCoord.out,chr3,41279476,41286789,+,9,0,9,known,chr3:41279476-41286789
sample_6_Aligned.sortedByCoord.out,chr17,29628861,29634158,+,9,2,11,known,chr17:29628861-29634158
sample_6_Aligned.sortedByCoord.out,chr5,36023898,36029637,+,7,1,8,known,chr5:36023898-36029637
sample_6_Aligned.sortedByCoord.out,chr7,34279944,34286171,-,12,2,14,known,chr7:34279944-34286171
sample_6_Aligned.sortedByCoord.out,chr17,1270192,1279584,+,9,3,12,known,chr17:1270192-1279584
sample_6_Aligned.sortedByCoord.out,chr5,34735991,34740642,-,14,0,14,known,chr5:34735991-34740642
sample_6_Aligned.sortedByCoord.out,chr21,25476024,25484046,+,11,0,11,known,chr21:25476024-25484046
sample_6_Aligned.sortedByCoord.out,chr12,49643976,49646154,-,10,1,11,known,chr12:49643976-49646154
sample_6_Aligned.sortedByCoord.out,chr12,15015893,15024558,-,16,4,20,known,chr12:15015893-15024558
sample_6_Aligned.sortedByCoord.out,chr16,40128851,40133975,-,9,3,12,known,chr16:40128851-40133975
sample_6_Aligned.sortedByCoord.out,chr11,5335218,5342910,-,12,5,17,novel,chr11:5335218-5342910
sample_6_Aligned.sortedByCoord.out,chr1,21756663,21764730,-,12,2,14,novel,chr1:21756663-21764730
sample_6_Aligned.sortedByCoord.out,chr17,12765654,12767282,-,9,0,9,known,chr17:12765654-12767282
sample_6_Aligned.sortedByCoord.out,chr1,35333124,35337441,+,13,3,16,known,chr1:35333124-35337441
sample_6_Aligned.sortedByCoord.out,chr14,4703230,4706139,-,8,3,11,known,chr14:4703230-4706139
sample_6_Aligned.sortedByCoord.out,chr20,37357235,37359306,+,12,2,14,known,chr20:37357235-37359306
sample_6_Aligned.sortedByCoord.out,chr14,11670279,11673897,+,11,3,14,novel,chr14:11670279-11673897
sample_6_Aligned.sortedByCoord.out,chr14,39346300,39353797,+,17,2,19,known,chr14:39346300-39353797
sample_6_Aligned.sortedByCoord.out,chr13,33211029,33215910,-,18,2,20,novel,chr13:33211029-33215910
sample_6_Aligned.sortedByCoord.out,chr8,16173546,16180916,-,7,1,8,known,chr8:16173546-16180916
sample_6_Aligned.sortedByCoord.out,chr10,23536203,23540735,+,11,4,15,known,chr10:23536203-23540735
sample_6_Aligned.sortedByCoord.out,chr10,48035594,48040521,-,10,2,12,known,chr10:48035594-48040521
sample_6_Aligned.sortedByCoord.out,chr1,30601878,30604230,-,11,1,12,known,chr1:30601878-30604230
sample_6_Aligned.sortedByCoord.out,chr14,3528588,3534705,+,9,1,10,known,chr14:3528588-3534705
sample_6_Aligned.sortedByCoord.out,chr15,10131402,10140934,-,10,2,12,known,chr15:10131402-10140934
sample_6_Aligned.sortedByCoord.out,chr7,45906501,45907159,+,14,1,15,known,chr7:45906501-45907159
sample_6_Aligned.sortedByCoord.out,chr22,36229726,36230462,-,14,1,15,known,chr22:36229726-36230462
sample_6_Aligned.sortedByCoord.out,chr18,43744336,43751125,-,5,0,5,known,chr18:43744336-43751125
sample_6_Aligned.sortedByCoord.out,chr11,36937427,36943653,+,11,1,12,known,chr11:36937427-36943653
sample_6_Aligned.sortedByCoord.out,chr8,45009976,45015752,-,10,3,13,known,chr8:45009976-45015752
sample_6_Aligned.sortedByCoord.out,chr7,45068588,45074582,-,8,4,12,known,chr7:45068588-45074582
sample_6_Aligned.sortedByCoord.out,chr8,5055531,5063761,-,11,2,13,known,chr8:5055531-5063761
sample_6_Aligned.sortedByCoord.out,chr2,44507267,44510600,+,10,2,12,known,chr2:44507267-44510600
sample_6_Aligned.sortedByCoord.out,chr14,42244507,42248201,+,2,1,3,known,chr14:42244507-42248201
sample_6_Aligned.sortedByCoord.out,chr4,31291709,31298287,-,11,2,13,known,chr4:31291709-31298287
sample_6_Aligned.sortedByCoord.out,chr15,19516473,19519625,+,13,3,16,novel,chr15:19516473-19519625
sample_6_Aligned.sortedByCoord.out,chr13,11220290,11225731,-,12,2,14,known,chr13:11220290-11225731
sample_6_Aligned.sortedByCoord.out,chr21,26191354,26196448,-,10,1,11,novel,chr21:26191354-26196448
sample_6_Aligned.sortedByCoord.out,chr10,9409794,9417271,+,19,4,23,novel,chr10:9409794-9417271
sample_6_Aligned.sortedByCoord.out,chr13,47356511,47360345,-,7,1,8,known,chr13:47356511-47360345
sample_6_Aligned.sortedByCoord.out,chr14,15886572,15891587,+,11,1,12,novel,chr14:15886572-15891587
sample_6_Aligned.sortedByCoord.out,chr9,12280567,12286296,-,11,3,14,novel,chr9:12280567-12286296
sample_6_Aligned.sortedByCoord.out,chr15,36518673,36524703,+,15,1,16,known,chr15:36518673-36524703
sample_6_Aligned.sortedByCoord.out,chr10,4858384,4861505,-,7,1,8,known,chr10:4858384-4861505
sample_6_Aligned.sortedByCoord.out,chr7,28587365,28588720,-,12,1,13,novel,chr7:28587365-28588720
sample_6_Aligned.sortedByCoord.out,chr21,34680284,34688790,-,8,3,11,known,chr21:34680284-34688790
sample_6_Aligned.sortedByCoord.out,chr22,25513032,25518084,+,10,3,13,known,chr22:25513032-25518084
sample_6_Aligned.sortedByCoord.out,chr12,44535903,44542195,-,12,4,16,known,chr12:44535903-44542195
sample_6_Aligned.sortedByCoord.out,chr11,26007710,26012098,+,10,2,12,known,chr11:26007710-26012098
sample_6_Aligned.sortedByCoord.out,chr18,45973350,45983034,-,10,2,12,known,chr18:45973350-45983034
sample_6_Aligned.sortedByCoord.out,chr14,19739429,19739675,+,9,3,12,known,chr14:19739429-19739675
sample_6_Aligned.sortedByCoord.out,chr13,29698169,29700533,+,12,1,13,known,chr13:29698169-29700533
sample_6_Aligned.sortedByCoord.out,chr7,41567445,41570036,+,12,1,13,novel,chr7:41567445-41570036
sample_6_Aligned.sortedByCoord.out,chr7,12204077,12208934,-,9,1,10,known,chr7:12204077-12208934
sample_6_Aligned.sortedByCoord.out,chr9,11667242,11669496,+,8,3,11,known,chr9:11667242-11669496
sample_6_Aligned.sortedByCoord.out,chr3,23582471,23592344,+,18,1,19,known,chr3:23582471-23592344
sample_6_Aligned.sortedByCoord.out,chr15,44706768,44711271,+,7,0,7,known,chr15:44706768-44711271
sample_6_Aligned.sortedByCoord.out,chr10,43047891,43057451,-,15,2,17,known,chr10:43047891-43057451
sample_6_Aligned.sortedByCoord.out,chr6,19524459,19529231,-,11,5,16,known,chr6:19524459-19529231
sample_6_Aligned.sortedByCoord.out,chr18,23101968,23104040,+,14,3,17,known,chr18:23101968-23104040
sample_6_Aligned.sortedByCoord.out,chr1,13175795,13179758,+,12,3,15,known,chr1:13175795-13179758
sample_6_Aligned.sortedByCoord.out,chr21,7865422,7866595,-,11,3,14,known,chr21:7865422-7866595
sample_6_Aligned.sortedByCoord.out,chr14,35363710,35368461,-,9,0,9,known,chr14:35363710-35368461
sample_6_Aligned.sortedByCoord.out,chr1,23152402,23158485,+,14,1,15,known,chr1:23152402-23158485
sample_6_Aligned.sortedByCoord.out,chr3,25501552,25507075,-,14,4,18,known,chr3:25501552-25507075
sample_6_Aligned.sortedByCoord.out,chr8,44913304,44913859,-,11,2,13,known,chr8:44913304-44913859
sample_6_Aligned.sortedByCoord.out,chr2,47753005,47760429,-,11,2,13,known,chr2:47753005-47760429
sample_6_Aligned.sortedByCoord.out,chr13,1698353,1703696,+,11,2,13,known,chr13:1698353-1703696
sample_6_Aligned.sortedByCoord.out,chr21,38667969,38671912,+,10,2,12,known,chr21:38667969-38671912
sample_6_Aligned.sortedByCoord.out,chr1,16139517,16147780,-,12,3,15,known,chr1:16139517-16147780
sample_6_Aligned.sortedByCoord.out,chr3,23945199,23946016,+,14,1,15,novel,chr3:23945199-23946016
sample_6_Aligned.sortedByCoord.out,chr17,29679423,29683713,-,9,2,11,novel,chr17:29679423-29683713
sample_6_Aligned.sortedByCoord.out,chr16,33227522,33234525,-,9,3,12,known,chr16:33227522-33234525
sample_6_Aligned.sortedByCoord.out,chr11,48578893,48585980,+,12,0,12,known,chr11:48578893-48585980
sample_6_Aligned.sortedByCoord.out,chr17,7809178,7812854,+,9,1,10,novel,chr17:7809178-7812854
sample_6_Aligned.sortedByCoord.out,chr15,48760343,48763927,+,8,3,11,known,chr15:48760343-48763927
sample_6_Aligned.sortedByCoord.out,chr13,24810494,24813512,+,17,1,18,known,chr13:24810494-24813512
sample_6_Aligned.sortedByCoord.out,chr16,1647068,1649550,+,10,2,12,known,chr16:1647068-1649550
sample_6_Aligned.sortedByCoord.out,chr19,41028412,41036565,-,12,0,12,known,chr19:41028412-41036565
sample_6_Aligned.sortedByCoord.out,chr9,24996188,25002978,+,10,2,12,known,chr9:24996188-25002978
sample_6_Aligned.sortedByCoord.out,chr6,26795210,26795459,+,8,1,9,novel,chr6:26795210-26795459
sample_6_Aligned.sortedByCoord.out,chr22,40767100,40771558,+,15,0,15,known,chr22:40767100-40771558
sample_6_Aligned.sortedByCoord.out,chr7,16426552,16427122,-,7,2,9,known,chr7:16426552-16427122
sample_6_Aligned.sortedByCoord.out,chr22,37590564,37592413,+,17,1,18,known,chr22:37590564-37592413
sample_6_Aligned.sortedByCoord.out,chr15,26933809,26938646,+,16,1,17,known,chr15:26933809-26938646
sample_6_Aligned.sortedByCoord.out,chr1,23009169,23014997,+,12,2,14,known,chr1:23009169-23014997
sample_6_Aligned.sortedByCoord.out,chr7,37279747,37288224,+,13,4,17,novel,chr7:37279747-37288224
sample_6_Aligned.sortedByCoord.out,chr21,3739500,3748698,+,9,2,11,known,chr21:3739500-3748698
sample_6_Aligned.sortedByCoord.out,chr13,30319165,30321021,+,5,3,8,known,chr13:30319165-30321021
sample_6_Aligned.sortedByCoord.out,chr18,34481613,34490381,+,10,3,13,known,chr18:34481613-34490381
sample_6_Aligned.sortedByCoord.out,chr2,31455739,31460218,+,9,4,13,novel,chr2:31455739-31460218
sample_6_Aligned.sortedByCoord.out,chr1,4486900,4493240,-,11,0,11,known,chr1:4486900-4493240
sample_6_Aligned.sortedByCoord.out,chr5,5951032,5953145,-,5,5,10,known,chr5:5951032-5953145
sample_6_Aligned.sortedByCoord.out,chr10,33739284,33742836,+,8,1,9,known,chr10:33739284-33742836
sample_6_Aligned.sortedByCoord.out,chr16,5747650,5755879,-,11,4,15,known,chr16:5747650-5755879
sample_6_Aligned.sortedByCoord.out,chr13,37439214,37445325,+,10,2,12,known,chr13:37439214-37445325
sample_6_Aligned.sortedByCoord.out,chr11,35477146,35484691,-,11,2,13,known,chr11:35477146-35484691
sample_6_Aligned.sortedByCoord.out,chr20,5171190,5177956,-,8,1,9,known,chr20:5171190-5177956
sample_6_Aligned.sortedByCoord.out,chr14,17804244,17812423,-,8,1,9,known,chr14:17804244-17812423
sample_6_Aligned.sortedByCoord.out,chr18,32663024,32670574,-,13,1,14,known,chr18:32663024-32670574
sample_6_Aligned.sortedByCoord.out,chr13,17223959,17224999,-,13,2,15,known,chr13:17223959-17224999
sample_6_Aligned.sortedByCoord.out,chr1,43098751,43100558,-,8,3,11,known,chr1:43098751-43100558
sample_6_Aligned.sortedByCoord.out,chr11,5300607,5302856,+,14,1,15,known,chr11:5300607-5302856
sample_6_Aligned.sortedByCoord.out,chr17,39169061,39171945,+,10,0,10,known,chr17:39169061-39171945
sample_6_Aligned.sortedByCoord.out,chr15,35285263,35290627,-,15,0,15,known,chr15:35285263-35290627
sample_6_Aligned.sortedByCoord.out,chr15,20492835,20501183,+,7,1,8,known,chr15:20492835-20501183
sample_6_Aligned.sortedByCoord.out,chr3,26667512,26675442,-,9,2,11,known,chr3:26667512-26675442
sample_6_Aligned.sortedByCoord.out,chr10,6951014,6960953,+,9,3,12,novel,chr10:6951014-6960953
sample_6_Aligned.sortedByCoord.out,chr15,31996683,31997845,+,10,1,11,known,chr15:31996683-31997845
sample_6_Aligned.sortedByCoord.out,chr5,11624066,11632567,+,13,1,14,novel,chr5:11624066-11632567
sample_6_Aligned.sortedByCoord.out,chr14,24378557,24380492,-,15,1,16,known,chr14:24378557-24380492
sample_6_Aligned.sortedByCoord.out,chr21,47502154,47507271,+,12,1,13,known,chr21:47502154-47507271
sample_6_Aligned.sortedByCoord.out,chr7,32887884,32890536,+,10,1,11,novel,chr7:32887884-32890536
sample_6_Aligned.sortedByCoord.out,chr10,46235615,46242110,+,9,4,13,known,chr10:46235615-46242110
sample_6_Aligned.sortedByCoord.out,chr20,21280958,21285682,-,12,0,12,known,chr20:21280958-21285682
sample_6_Aligned.sortedByCoord.out,chr10,33117772,33124385,+,8,1,9,novel,chr10:33117772-33124385
sample_6_Aligned.sortedByCoord.out,chr22,47064902,47070550,+,10,3,13,known,chr22:47064902-47070550
sample_6_Aligned.sortedByCoord.out,chr1,18617533,18617980,+,11,3,14,known,chr1:18617533-18617980
sample_6_Aligned.sortedByCoord.out,chr16,15470864,15480107,-,15,2,17,known,chr16:15470864-15480107
sample_6_Aligned.sortedByCoord.out,chr6,1411515,1414123,+,11,3,14,known,chr6:1411515-1414123
sample_6_Aligned.sortedByCoord.out,chr10,47872026,47873798,-,10,5,15,known,chr10:47872026-47873798
sample_6_Aligned.sortedByCoord.out,chr12,49894757,49895893,-,13,2,15,novel,chr12:49894757-49895893
sample_6_Aligned.sortedByCoord.out,chr21,44918366,44925332,-,13,1,14,known,chr21:44918366-44925332
sample_6_Aligned.sortedByCoord.out,chr3,43231696,43240154,-,9,2,11,known,chr3:43231696-43240154
sample_6_Aligned.sortedByCoord.out,chr8,17824281,17825109,-,11,1,12,known,chr8:17824281-17825109
sample_6_Aligned.sortedByCoord.out,chr2,23695769,23702830,+,8,2,10,known,chr2:23695769-23702830
sample_6_Aligned.sortedByCoord.out,chr2,12233584,12240931,+,10,2,12,novel,chr2:12233584-12240931
sample_6_Aligned.sortedByCoord.out,chr17,23717248,23721693,+,13,0,13,known,chr17:23717248-23721693
sample_6_Aligned.sortedByCoord.out,chr3,42948863,42955969,+,7,2,9,known,chr3:42948863-42955969
sample_6_Aligned.sortedByCoord.out,chr7,46795715,46797410,-,5,4,9,known,chr7:46795715-46797410
sample_6_Aligned.sortedByCoord.out,chr3,6731064,6739656,-,7,2,9,novel,chr3:6731064-6739656
sample_6_Aligned.sortedByCoord.out,chr17,11222393,11226098,+,12,1,13,known,chr17:11222393-11226098
sample_6_Aligned.sortedByCoord.out,chr4,36453445,36455924,+,11,1,12,known,chr4:36453445-36455924
sample_6_Aligned.sortedByCoord.out,chr2,39934938,39943602,+,9,0,9,known,chr2:39934938-39943602
sample_6_Aligned.sortedByCoord.out,chr19,20942033,20946458,+,8,0,8,known,chr19:20942033-20946458
sample_6_Aligned.sortedByCoord.out,chr9,15207370,15214845,-,10,1,11,novel,chr9:15207370-15214845
sample_6_Aligned.sortedByCoord.out,chr3,41141507,41150648,-,9,2,11,novel,chr3:41141507-41150648
sample_6_Aligned.sortedByCoord.out,chr17,6107730,6110028,-,12,1,13,known,chr17:6107730-6110028
sample_6_Aligned.sortedByCoord.out,chr1,9818460,9826692,+,13,4,17,known,chr1:9818460-9826692
sample_6_Aligned.sortedByCoord.out,chr3,5455583,5457809,+,8,3,11,known,chr3:5455583-5457809
sample_6_Aligned.sortedByCoord.out,chr10,35784892,35790792,+,11,2,13,known,chr10:35784892-35790792
sample_6_Aligned.sortedByCoord.out,chr2,34707980,34711858,+,17,2,19,known,chr2:34707980-34711858
sample_6_Aligned.sortedByCoord.out,chr20,27529063,27532846,-,9,4,13,known,chr20:27529063-27532846
sample_6_Aligned.sortedByCoord.out,chr12,21038806,21046902,-,11,0,11,known,chr12:21038806-21046902
sample_6_Aligned.sortedByCoord.out,chr15,3898817,3907508,-,9,2,11,known,chr15:3898817-3907508
sample_6_Aligned.sortedByCoord.out,chr4,37053340,37053747,+,7,3,10,known,chr4:37053340-37053747
sample_6_Aligned.sortedByCoord.out,chr4,10597112,10598113,-,8,5,13,known,chr4:10597112-10598113
sample_6_Aligned.sortedByCoord.out,chr6,31487426,31491676,+,11,1,12,known,chr6:31487426-31491676
sample_6_Aligned.sortedByCoord.out,chr14,23821307,23826011,+,5,3,8,known,chr14:23821307-23826011
sample_6_Aligned.sortedByCoord.out,chr18,15561163,15568051,-,11,1,12,known,chr18:15561163-15568051
sample_6_Aligned.sortedByCoord.out,chr7,30686556,30687719,+,9,4,13,known,chr7:30686556-30687719
sample_6_Aligned.sortedByCoord.out,chr16,4123076,4132236,-,15,2,17,novel,chr16:4123076-4132236
sample_6_Aligned.sortedByCoord.out,chr6,23378891,23382832,+,8,1,9,novel,chr6:23378891-23382832
sample_6_Aligned.sortedByCoord.out,chr11,1729093,1736922,+,9,3,12,novel,chr11:1729093-1736922
sample_6_Aligned.sortedByCoord.out,chr6,38147539,38153168,-,8,0,8,novel,chr6:38147539-38153168
sample_6_Aligned.sortedByCoord.out,chr3,16425371,16428457,-,6,2,8,known,chr3:16425371-16428457
sample_6_Aligned.sortedByCoord.out,chr20,2435149,2435249,+,9,2,11,known,chr20:2435149-2435249
sample_6_Aligned.sortedByCoord.out,chr19,20763629,20771041,+,10,2,12,known,chr19:20763629-20771041
sample_6_Aligned.sortedByCoord.out,chr19,12197932,12200706,+,9,3,12,known,chr19:12197932-12200706
sample_6_Aligned.sortedByCoord.out,chr22,2237242,2242053,-,6,1,7,novel,chr22:2237242-2242053
sample_6_Aligned.sortedByCoord.out,chr14,11277168,11278091,-,11,0,11,known,chr14:11277168-11278091
sample_6_Aligned.sortedByCoord.out,chr17,44705894,44708091,-,10,5,15,novel,chr17:44705894-44708091
sample_6_Aligned.sortedByCoord.out,chr5,4860937,4863400,+,5,3,8,known,chr5:4860937-4863400
sample_6_Aligned.sortedByCoord.out,chr14,28732896,28741755,-,4,2,6,known,chr14:28732896-28741755
sample_6_Aligned.sortedByCoord.out,chr18,11990739,11993336,-,10,1,11,known,chr18:11990739-11993336
sample_6_Aligned.sortedByCoord.out,chr21,1829413,1838208,-,12,0,12,known,chr21:1829413-1838208
sample_6_Aligned.sortedByCoord.out,chr5,39292868,39295252,+,13,1,14,novel,chr5:39292868-39295252
sample_6_Aligned.sortedByCoord.out,chr13,24150471,24154054,-,12,3,15,known,chr13:24150471-24154054
sample_6_Aligned.sortedByCoord.out,chr20,32813595,32819636,-,12,1,13,novel,chr20:32813595-32819636
sample_6_Aligned.sortedByCoord.out,chr13,19334455,19341918,+,8,5,13,novel,chr13:19334455-19341918
sample_6_Aligned.sortedByCoord.out,chr7,2837554,2845585,-,11,1,12,known,chr7:2837554-2845585
sample_6_Aligned.sortedByCoord.out,chr17,29477802,29482227,+,15,1,16,known,chr17:29477802-29482227
sample_6_Aligned.sortedByCoord.out,chr20,14189891,14194488,+,10,2,12,novel,chr20:14189891-14194488
sample_6_Aligned.sortedByCoord.out,chr21,9666419,9666810,+,9,7,16,known,chr21:9666419-9666810
sample_6_Aligned.sortedByCoord.out,chr21,9191299,9192277,+,10,3,13,known,chr21:9191299-9192277
sample_6_Aligned.sortedByCoord.out,chr6,43845480,43851401,-,7,2,9,known,chr6:43845480-43851401
sample_6_Aligned.sortedByCoord.out,chr20,49160332,49162692,-,10,2,12,novel,chr20:49160332-49162692
sample_6_Aligned.sortedByCoord.out,chr21,18302210,18302403,+,11,2,13,known,chr21:18302210-18302403
sample_6_Aligned.sortedByCoord.out,chr1,35963596,35973398,+,10,0,10,known,chr1:35963596-35973398
sample_6_Aligned.sortedByCoord.out,chr22,39165712,39174189,+,6,2,8,novel,chr22:39165712-39174189
sample_6_Aligned.sortedByCoord.out,chr10,16257046,16266445,+,10,6,16,known,chr10:16257046-16266445
sample_6_Aligned.sortedByCoord.out,chr4,38492580,38500909,-,11,1,12,known,chr4:38492580-38500909
sample_6_Aligned.sortedByCoord.out,chr21,34054547,34060481,-,12,2,14,known,chr21:34054547-34060481
sample_6_Aligned.sortedByCoord.out,chr3,46261913,46268809,+,11,4,15,known,chr3:46261913-46268809
sample_6_Aligned.sortedByCoord.out,chr7,2937081,2937747,+,14,2,16,known,chr7:2937081-2937747
sample_6_Aligned.sortedByCoord.out,chr7,47661791,47669919,-,11,4,15,novel,chr7:47661791-47669919
sample_6_Aligned.sortedByCoord.out,chr21,5681518,5682345,+,11,0,11,known,chr21:5681518-5682345
sample_6_Aligned.sortedByCoord.out,chr3,11772506,11781047,-,8,1,9,known,chr3:11772506-11781047
sample_6_Aligned.sortedByCoord.out,chr22,23861657,23871083,+,8,0,8,novel,chr22:23861657-23871083
sample_6_Aligned.sortedByCoord.out,chr13,43067055,43076399,-,14,1,15,known,chr13:43067055-43076399
sample_6_Aligned.sortedByCoord.out,chr6,26863718,26866207,+,7,1,8,known,chr6:26863718-26866207
sample_6_Aligned.sortedByCoord.out,chr14,44955754,44963188,+,10,2,12,known,chr14:44955754-44963188
sample_6_Aligned.sortedByCoord.out,chr20,16448331,16457327,+,8,0,8,known,chr20:16448331-16457327
sample_6_Aligned.sortedByCoord.out,chr19,9338996,9343535,+,8,1,9,known,chr19:9338996-9343535
sample_6_Aligned.sortedByCoord.out,chr18,4880312,4882736,+,5,2,7,known,chr18:4880312-4882736
sample_6_Aligned.sortedByCoord.out,chr3,3565849,3571318,-,8,3,11,known,chr3:3565849-3571318
sample_6_Aligned.sortedByCoord.out,chr2,31319297,31326225,+,10,3,13,known,chr2:31319297-31326225
sample_6_Aligned.sortedByCoord.out,chr18,42210517,42217463,-,8,3,11,known,chr18:42210517-42217463
sample_6_Aligned.sortedByCoord.out,chr22,26644364,26654111,-,13,3,16,known,chr22:26644364-26654111
sample_6_Aligned.sortedByCoord.out,chr13,8623953,8628923,+,12,2,14,known,chr13:8623953-8628923
sample_6_Aligned.sortedByCoord.out,chr12,36671399,36675209,-,10,1,11,known,chr12:36671399-36675209
sample_6_Aligned.sortedByCoord.out,chr1,42836810,42843566,-,9,3,12,known,chr1:42836810-42843566
sample_6_Aligned.sortedByCoord.out,chr19,33023365,33032234,-,11,3,14,known,chr19:33023365-33032234
sample_6_Aligned.sortedByCoord.out,chr6,31929298,31933873,-,7,2,9,known,chr6:31929298-31933873
sample_6_Aligned.sortedByCoord.out,chr18,22832826,22839895,+,10,0,10,novel,chr18:22832826-22839895
sample_6_Aligned.sortedByCoord.out,chr15,38779116,38789070,+,9,0,9,novel,chr15:38779116-38789070
sample_6_Aligned.sortedByCoord.out,chr13,15513438,15519535,-,10,1,11,known,chr13:15513438-15519535
sample_6_Aligned.sortedByCoord.out,chr5,28009811,28010720,-,7,0,7,known,chr5:28009811-28010720
sample_6_Aligned.sortedByCoord.out,chr15,1226364,1226651,+,15,4,19,known,chr15:1226364-1226651
sample_6_Aligned.sortedByCoord.out,chr1,11772221,11774258,+,11,3,14,known,chr1:11772221-11774258
sample_6_Aligned.sortedByCoord.out,chr3,18665324,18674082,+,14,5,19,novel,chr3:18665324-18674082
sample_6_Aligned.sortedByCoord.out,chr11,17197548,17205340,-,6,2,8,known,chr11:17197548-17205340
sample_6_Aligned.sortedByCoord.out,chr7,4213926,4215948,-,13,4,17,known,chr7:4213926-4215948
sample_6_Aligned.sortedByCoord.out,chr7,19004329,19012722,+,6,2,8,known,chr7:19004329-19012722
sample_6_Aligned.sortedByCoord.out,chr17,25981894,25987351,+,12,2,14,known,chr17:25981894-25987351
sample_6_Aligned.sortedByCoord.out,chr13,8396729,8404535,+,10,4,14,known,chr13:8396729-8404535
sample_6_Aligned.sortedByCoord.out,chr19,23162717,23169918,+,13,1,14,known,chr19:23162717-23169918
sample_6_Aligned.sortedByCoord.out,chr1,9738118,9742783,-,5,2,7,known,chr1:9738118-9742783
sample_6_Aligned.sortedByCoord.out,chr5,6445928,6451510,-,11,2,13,known,chr5:6445928-6451510
sample_6_Aligned.sortedByCoord.out,chr18,16064282,16070526,-,8,1,9,known,chr18:16064282-16070526
sample_6_Aligned.sortedByCoord.out,chr20,12228238,12229041,+,11,2,13,novel,chr20:12228238-12229041
sample_6_Aligned.sortedByCoord.out,chr14,44759342,44761375,+,8,1,9,known,chr14:44759342-44761375
sample_6_Aligned.sortedByCoord.out,chr14,29258366,29267930,+,13,3,16,known,chr14:29258366-29267930
sample_6_Aligned.sortedByCoord.out,chr13,44644773,44647394,-,5,1,6,novel,chr13:44644773-44647394
sample_6_Aligned.sortedByCoord.out,chr21,17212919,17219548,-,6,3,9,novel,chr21:17212919-17219548
sample_6_Aligned.sortedByCoord.out,chr3,31240078,31247801,-,10,2,12,known,chr3:31240078-31247801
sample_6_Aligned.sortedByCoord.out,chr20,34745643,34755609,+,9,4,13,known,chr20:34745643-34755609
sample_6_Aligned.sortedByCoord.out,chr4,31574643,31575890,+,13,1,14,known,chr4:31574643-31575890
sample_6_Aligned.sortedByCoord.out,chr15,29612454,29619573,-,6,1,7,known,chr15:29612454-29619573
sample_6_Aligned.sortedByCoord.out,chr8,40204834,40213559,+,10,1,11,novel,chr8:40204834-40213559
sample_6_Aligned.sortedByCoord.out,chr2,30733897,30734099,+,12,3,15,known,chr2:30733897-30734099
sample_6_Aligned.sortedByCoord.out,chr10,16582718,16590060,+,11,1,12,known,chr10:16582718-16590060
sample_6_Aligned.sortedByCoord.out,chr17,40951023,40951335,-,6,4,10,known,chr17:40951023-40951335
sample_6_Aligned.sortedByCoord.out,chr5,49113317,49116161,+,3,1,4,known,chr5:49113317-49116161
sample_6_Aligned.sortedByCoord.out,chr9,11608320,11611301,+,12,3,15,known,chr9:11608320-11611301
sample_6_Aligned.sortedByCoord.out,chr8,34998808,35005295,+,10,2,12,known,chr8:34998808-35005295
sample_6_Aligned.sortedByCoord.out,chr18,29278834,29287279,-,10,3,13,known,chr18:29278834-29287279
sample_6_Aligned.sortedByCoord.out,chr14,16961989,16966501,+,7,1,8,known,chr14:16961989-16966501
sample_6_Aligned.sortedByCoord.out,chr3,40717913,40723331,+,11,4,15,known,chr3:40717913-40723331
sample_6_Aligned.sortedByCoord.out,chr13,12866527,12867895,-,6,1,7,known,chr13:12866527-12867895
sample_6_Aligned.sortedByCoord.out,chr10,15703075,15704813,+,17,3,20,known,chr10:15703075-15704813
sample_6_Aligned.sortedByCoord.out,chr18,13475383,13475887,+,4,3,7,known,chr18:13475383-13475887
sample_6_Aligned.sortedByCoord.out,chr17,24052836,24058511,-,13,2,15,known,chr17:24052836-24058511
sample_6_Aligned.sortedByCoord.out,chr3,44158866,44160985,+,12,6,18,known,chr3:44158866-44160985
sample_6_Aligned.sortedByCoord.out,chr15,1937744,1941187,+,5,2,7,known,chr15:1937744-1941187
sample_6_Aligned.sortedByCoord.out,chr20,24911762,24912117,+,8,6,14,known,chr20:24911762-24912117
sample_6_Aligned.sortedByCoord.out,chr17,5996580,6003649,-,8,2,10,known,chr17:5996580-6003649
sample_6_Aligned.sortedByCoord.out,chr19,6346849,6353262,+,10,3,13,known,chr19:6346849-6353262
sample_6_Aligned.sortedByCoord.out,chr10,49371578,49381209,-,8,5,13,known,chr10:49371578-49381209
sample_6_Aligned.sortedByCoord.out,chr9,40665243,40668373,+,6,3,9,known,chr9:40665243-40668373
sample_6_Aligned.sortedByCoord.out,chr14,32739712,32741559,+,4,2,6,known,chr14:32739712-32741559
sample_6_Aligned.sortedByCoord.out,chr9,32944029,32946764,+,5,3,8,known,chr9:32944029-32946764
sample_6_Aligned.sortedByCoord.out,chr22,28543912,28547510,+,8,1,9,novel,chr22:28543912-28547510
sample_6_Aligned.sortedByCoord.out,chr2,15170517,15179893,-,11,2,13,known,chr2:15170517-15179893
sample_6_Aligned.sortedByCoord.out,chr10,10563943,10565910,-,12,3,15,known,chr10:10563943-10565910
sample_6_Aligned.sortedByCoord.out,chr2,20929739,20939684,+,8,3,11,known,chr2:20929739-20939684
sample_6_Aligned.sortedByCoord.out,chr1,31384112,31390046,+,18,1,19,known,chr1:31384112-31390046
sample_6_Aligned.sortedByCoord.out,chr1,3600507,3602220,-,11,4,15,known,chr1:3600507-3602220
sample_6_Aligned.sortedByCoord.out,chr5,11126344,11128981,+,11,6,17,known,chr5:11126344-11128981
sample_6_Aligned.sortedByCoord.out,chr16,16867526,16867820,+,13,1,14,novel,chr16:16867526-16867820
sample_6_Aligned.sortedByCoord.out,chr21,47801649,47802634,+,15,2,17,known,chr21:47801649-47802634
sample_6_Aligned.sortedByCoord.out,chr6,24242118,24242221,-,10,4,14,known,chr6:24242118-24242221
sample_6_Aligned.sortedByCoord.out,chr12,14642472,14650116,-,10,2,12,novel,chr12:14642472-14650116
sample_6_Aligned.sortedByCoord.out,chr4,21746301,21749586,+,6,1,7,novel,chr4:21746301-21749586
sample_6_Aligned.sortedByCoord.out,chr14,38614584,38617619,-,9,0,9,known,chr14:38614584-38617619
sample_6_Aligned.sortedByCoord.out,chr2,48037649,48045193,-,7,2,9,known,chr2:48037649-48045193
sample_6_Aligned.sortedByCoord.out,chr19,36366805,36367192,-,4,5,9,known,chr19:36366805-36367192
sample_6_Aligned.sortedByCoord.out,chr16,44587946,44595329,+,9,0,9,known,chr16:44587946-44595329
sample_6_Aligned.sortedByCoord.out,chr4,39312908,39322375,-,9,1,10,known,chr4:39312908-39322375
sample_6_Aligned.sortedByCoord.out,chr15,40556440,40558716,+,9,1,10,known,chr15:40556440-40558716
sample_6_Aligned.sortedByCoord.out,chr14,46244157,46252671,+,14,2,16,known,chr14:46244157-46252671
sample_6_Aligned.sortedByCoord.out,chr13,27870641,27879210,+,5,2,7,known,chr13:27870641-27879210
sample_6_Aligned.sortedByCoord.out,chr22,29702884,29704032,+,9,1,10,known,chr22:29702884-29704032
sample_6_Aligned.sortedByCoord.out,chr19,37905639,37910793,+,14,0,14,known,chr19:37905639-37910793
sample_6_Aligned.sortedByCoord.out,chr21,9715881,9725608,+,9,3,12,known,chr21:9715881-9725608
sample_6_Aligned.sortedByCoord.out,chr5,5486155,5489545,-,12,4,16,novel,chr5:5486155-5489545
sample_6_Aligned.sortedByCoord.out,chr20,48300600,48309005,+,16,2,18,known,chr20:48300600-48309005
sample_6_Aligned.sortedByCoord.out,chr4,1015033,1016622,-,9,4,13,known,chr4:1015033-1016622
sample_6_Aligned.sortedByCoord.out,chr15,19758584,19760456,-,11,2,13,known,chr15:19758584-19760456
sample_6_Aligned.sortedByCoord.out,chr6,40932209,40933106,-,12,2,14,known,chr6:40932209-40933106
sample_6_Aligned.sortedByCoord.out,chr9,49613882,49614853,-,10,0,10,novel,chr9:49613882-49614853
sample_6_Aligned.sortedByCoord.out,chr4,11726372,11729690,+,14,1,15,known,chr4:11726372-11729690
sample_6_Aligned.sortedByCoord.out,chr7,41780162,41789553,+,7,3,10,novel,chr7:41780162-41789553
sample_6_Aligned.sortedByCoord.out,chr10,41922962,41930900,+,11,2,13,known,chr10:41922962-41930900
sample_6_Aligned.sortedByCoord.out,chr19,6462623,6471884,+,11,2,13,known,chr19:6462623-6471884
sample_6_Aligned.sortedByCoord.out,chr21,29630202,29635628,+,16,0,16,known,chr21:29630202-29635628
sample_6_Aligned.sortedByCoord.out,chr12,48432371,48441176,+,16,4,20,known,chr12:48432371-48441176
sample_6_Aligned.sortedByCoord.out,chr13,4790189,4797729,+,16,3,19,novel,chr13:4790189-4797729
sample_6_Aligned.sortedByCoord.out,chr4,43796200,43798490,+,12,1,13,novel,chr4:43796200-43798490
sample_6_Aligned.sortedByCoord.out,chr17,1310726,1312666,+,8,3,11,novel,chr17:1310726-1312666
sample_6_Aligned.sortedByCoord.out,chr12,30732057,30733437,-,10,2,12,known,chr12:30732057-30733437
sample_6_Aligned.sortedByCoord.out,chr16,35249314,35258516,+,14,0,14,known,chr16:35249314-35258516
sample_6_Aligned.sortedByCoord.out,chr5,49845465,49850057,+,8,1,9,known,chr5:49845465-49850057
sample_6_Aligned.sortedByCoord.out,chr14,46467555,46476117,+,7,1,8,known,chr14:46467555-46476117
sample_6_Aligned.sortedByCoord.out,chr3,43972966,43974991,-,20,0,20,known,chr3:43972966-43974991
sample_6_Aligned.sortedByCoord.out,chr9,19175968,19185581,-,9,5,14,known,chr9:19175968-19185581
sample_6_Aligned.sortedByCoord.out,chr8,3950930,3956643,+,5,1,6,known,chr8:3950930-3956643
sample_6_Aligned.sortedByCoord.out,chr11,45474990,45479831,+,15,1,16,known,chr11:45474990-45479831
sample_6_Aligned.sortedByCoord.out,chr6,9088301,9089269,+,7,1,8,known,chr6:9088301-9089269
sample_6_Aligned.sortedByCoord.out,chr18,36920441,36927154,+,6,1,7,known,chr18:36920441-36927154
sample_6_Aligned.sortedByCoord.out,chr1,33464034,33467008,-,9,3,12,known,chr1:33464034-33467008
sample_6_Aligned.sortedByCoord.out,chr1,24482777,24484551,+,4,3,7,known,chr1:24482777-24484551
sample_6_Aligned.sortedByCoord.out,chr17,17079242,17081613,+,12,2,14,known,chr17:17079242-17081613
sample_6_Aligned.sortedByCoord.out,chr4,29177098,29185880,-,5,0,5,known,chr4:29177098-29185880
sample_6_Aligned.sortedByCoord.out,chr16,38843775,38844640,+,8,3,11,known,chr16:38843775-38844640
sample_6_Aligned.sortedByCoord.out,chr19,46799417,46803318,-,10,1,11,novel,chr19:46799417-46803318
sample_6_Aligned.sortedByCoord.out,chr7,21358301,21360724,+,12,2,14,known,chr7:21358301-21360724
sample_6_Aligned.sortedByCoord.out,chr10,37890932,37892080,+,8,1,9,known,chr10:37890932-37892080
sample_6_Aligned.sortedByCoord.out,chr19,29347536,29354352,-,13,2,15,novel,chr19:29347536-29354352
sample_6_Aligned.sortedByCoord.out,chr8,47967790,47972779,-,8,2,10,known,chr8:47967790-47972779
sample_6_Aligned.sortedByCoord.out,chr5,34799357,34801145,+,17,2,19,known,chr5:34799357-34801145
sample_6_Aligned.sortedByCoord.out,chr9,38180968,38188551,-,10,3,13,novel,chr9:38180968-38188551
sample_6_Aligned.sortedByCoord.out,chr7,25349090,25353732,-,14,2,16,known,chr7:25349090-25353732
sample_6_Aligned.sortedByCoord.out,chr13,30442039,30450520,-,12,1,13,known,chr13:30442039-30450520
sample_6_Aligned.sortedByCoord.out,chr8,9633917,9638543,-,7,0,7,known,chr8:9633917-9638543
sample_6_Aligned.sortedByCoord.out,chr16,23310101,23316600,+,10,1,11,known,chr16:23310101-23316600
sample_6_Aligned.sortedByCoord.out,chr18,43289004,43291606,-,12,3,15,novel,chr18:43289004-43291606
sample_6_Aligned.sortedByCoord.out,chr10,28488242,28490058,+,11,2,13,known,chr10:28488242-28490058
sample_6_Aligned.sortedByCoord.out,chr20,9752932,9758647,+,7,3,10,known,chr20:9752932-9758647
sample_6_Aligned.sortedByCoord.out,chr13,1063002,1063280,+,4,5,9,known,chr13:1063002-1063280
sample_6_Aligned.sortedByCoord.out,chr16,33495215,33495558,+,6,2,8,known,chr16:33495215-33495558
sample_6_Aligned.sortedByCoord.out,chr13,12444088,12446665,+,12,3,15,known,chr13:12444088-12446665
sample_6_Aligned.sortedByCoord.out,chr8,16990493,16997222,-,14,0,14,known,chr8:16990493-16997222
sample_6_Aligned.sortedByCoord.out,chr16,14044135,14053883,+,2,0,2,known,chr16:14044135-14053883
sample_6_Aligned.sortedByCoord.out,chr22,15229459,15232759,-,6,3,9,known,chr22:15229459-15232759
sample_6_Aligned.sortedByCoord.out,chr19,13779309,13787835,-,11,6,17,known,chr19:13779309-13787835
sample_6_Aligned.sortedByCoord.out,chr1,36034176,36038906,+,11,3,14,known,chr1:36034176-36038906
sample_6_Aligned.sortedByCoord.out,chr3,16759928,16763935,-,9,6,15,known,chr3:16759928-16763935
sample_6_Aligned.sortedByCoord.out,chr10,45680127,45683808,+,6,1,7,known,chr10:45680127-45683808
sample_6_Aligned.sortedByCoord.out,chr3,3143962,3153445,-,10,2,12,known,chr3:3143962-3153445
sample_6_Aligned.sortedByCoord.out,chr20,10330946,10334050,-,11,1,12,novel,chr20:10330946-10334050
sample_6_Aligned.sortedByCoord.out,chr4,12723191,12732926,+,5,2,7,known,chr4:12723191-12732926
sample_6_Aligned.sortedByCoord.out,chr20,45787757,45796870,-,17,1,18,known,chr20:45787757-45796870
sample_6_Aligned.sortedByCoord.out,chr3,37939015,37947443,+,3,1,4,known,chr3:37939015-37947443
sample_6_Aligned.sortedByCoord.out,chr1,42613974,42622003,-,6,3,9,known,chr1:42613974-42622003
sample_6_Aligned.sortedByCoord.out,chr15,15875645,15884367,-,5,4,9,known,chr15:15875645-15884367
sample_6_Aligned.sortedByCoord.out,chr13,26384136,26386739,+,10,2,12,known,chr13:26384136-26386739
sample_6_Aligned.sortedByCoord.out,chr4,8012030,8015152,+,11,2,13,known,chr4:8012030-8015152
sample_6_Aligned.sortedByCoord.out,chr21,17809223,17818180,-,6,2,8,known,chr21:17809223-17818180
sample_6_Aligned.sortedByCoord.out,chr18,17850460,17856579,-,4,0,4,known,chr18:17850460-17856579
sample_6_Aligned.sortedByCoord.out,chr6,29530295,29535985,-,13,3,16,known,chr6:29530295-29535985
sample_6_Aligned.sortedByCoord.out,chr16,38553656,38557117,+,9,2,11,known,chr16:38553656-38557117
sample_6_Aligned.sortedByCoord.out,chr13,7132407,7142383,-,11,3,14,known,chr13:7132407-7142383
sample_6_Aligned.sortedByCoord.out,chr15,31077494,31083247,+,17,3,20,known,chr15:31077494-31083247
sample_6_Aligned.sortedByCoord.out,chr13,45131756,45138121,-,7,1,8,novel,chr13:45131756-45138121
sample_6_Aligned.sortedByCoord.out,chr7,1552970,1557097,-,5,4,9,known,chr7:1552970-1557097
sample_6_Aligned.sortedByCoord.out,chr22,3582914,3587834,+,10,1,11,known,chr22:3582914-3587834
sample_6_Aligned.sortedByCoord.out,chr3,14512643,14514831,+,12,0,12,known,chr3:14512643-14514831
sample_6_Aligned.sortedByCoord.out,chr12,46407958,46410274,-,7,2,9,known,chr12:46407958-46410274
sample_6_Aligned.sortedByCoord.out,chr18,14143234,14148434,+,9,0,9,known,chr18:14143234-14148434
sample_6_Aligned.sortedByCoord.out,chr2,49157785,49165640,+,12,3,15,known,chr2:49157785-49165640
sample_6_Aligned.sortedByCoord.out,chr16,8635132,8637664,+,14,3,17,novel,chr16:8635132-8637664
sample_6_Aligned.sortedByCoord.out,chr9,42369422,42372475,-,6,4,10,novel,chr9:42369422-42372475
sample_6_Aligned.sortedByCoord.out,chr19,49466006,49470269,-,9,1,10,known,chr19:49466006-49470269
sample_6_Aligned.sortedByCoord.out,chr21,3630347,3638434,+,6,4,10,known,chr21:3630347-3638434
sample_6_Aligned.sortedByCoord.out,chr22,31082757,31084686,-,4,2,6,known,chr22:31082757-31084686
sample_6_Aligned.sortedByCoord.out,chr20,21962347,21966784,-,11,0,11,novel,chr20:21962347-21966784
sample_6_Aligned.sortedByCoord.out,chr17,9219300,9223261,+,6,2,8,known,chr17:9219300-9223261
sample_6_Aligned.sortedByCoord.out,chr2,6876972,6883297,+,13,2,15,known,chr2:6876972-6883297
sample_6_Aligned.sortedByCoord.out,chr22,20667586,20673504,-,12,2,14,known,chr22:20667586-20673504
sample_6_Aligned.sortedByCoord.out,chr16,19502689,19505264,+,16,3,19,known,chr16:19502689-19505264
sample_6_Aligned.sortedByCoord.out,chr22,30342339,30349956,+,10,4,14,known,chr22:30342339-30349956
sample_6_Aligned.sortedByCoord.out,chr14,37633913,37642344,+,14,6,20,novel,chr14:37633913-37642344
sample_6_Aligned.sortedByCoord.out,chr3,11917990,11919048,-,11,4,15,known,chr3:11917990-11919048
sample_6_Aligned.sortedByCoord.out,chr14,36501780,36503671,+,10,1,11,known,chr14:36501780-36503671
sample_6_Aligned.sortedByCoord.out,chr13,48962074,48966253,+,9,4,13,known,chr13:48962074-48966253
sample_6_Aligned.sortedByCoord.out,chr9,11263921,11264887,-,10,2,12,known,chr9:11263921-11264887
sample_6_Aligned.sortedByCoord.out,chr6,26686418,26692642,+,12,4,16,known,chr6:26686418-26692642
sample_6_Aligned.sortedByCoord.out,chr4,36117896,36123948,+,9,1,10,known,chr4:36117896-36123948
sample_6_Aligned.sortedByCoord.out,chr4,20712960,20714868,+,8,3,11,known,chr4:20712960-20714868
sample_6_Aligned.sortedByCoord.out,chr17,49093457,49095451,-,9,2,11,novel,chr17:49093457-49095451
sample_6_Aligned.sortedByCoord.out,chr14,7775398,7780147,-,11,1,12,novel,chr14:7775398-7780147
sample_6_Aligned.sortedByCoord.out,chr7,4254049,4261383,-,4,0,4,known,chr7:4254049-4261383
sample_6_Aligned.sortedByCoord.out,chr9,45183054,45184616,+,13,2,15,known,chr9:45183054-45184616
sample_6_Aligned.sortedByCoord.out,chr3,21599029,21605494,+,9,3,12,known,chr3:21599029-21605494
sample_6_Aligned.sortedByCoord.out,chr9,36133255,36134494,-,6,1,7,known,chr9:36133255-36134494
sample_6_Aligned.sortedByCoord.out,chr18,4149877,4158724,-,3,3,6,known,chr18:4149877-4158724
sample_6_Aligned.sortedByCoord.out,chr13,40592158,40593888,+,14,1,15,novel,chr13:40592158-40593888
sample_6_Aligned.sortedByCoord.out,chr2,24451469,24452701,-,12,2,14,known,chr2:24451469-24452701
sample_6_Aligned.sortedByCoord.out,chr16,24747549,24750263,-,10,1,11,known,chr16:24747549-24750263
sample_6_Aligned.sortedByCoord.out,chr10,46923961,46931661,+,5,3,8,known,chr10:46923961-46931661
sample_6_Aligned.sortedByCoord.out,chr2,41612623,41620069,-,19,1,20,novel,chr2:41612623-41620069
sample_6_Aligned.sortedByCoord.out,chr15,44171930,44174995,+,9,3,12,known,chr15:44171930-44174995
sample_6_Aligned.sortedByCoord.out,chr15,31598643,31605554,+,4,5,9,known,chr15:31598643-31605554
sample_6_Aligned.sortedByCoord.out,chr19,48934956,48938866,+,9,3,12,known,chr19:48934956-48938866
sample_6_Aligned.sortedByCoord.out,chr5,27163954,27168425,+,10,0,10,novel,chr5:27163954-27168425
sample_6_Aligned.sortedByCoord.out,chr2,30359043,30365217,-,7,1,8,known,chr2:30359043-30365217
sample_6_Aligned.sortedByCoord.out,chr8,7479571,7481703,+,9,4,13,known,chr8:7479571-7481703
sample_6_Aligned.sortedByCoord.out,chr3,20284840,20290744,-,13,5,18,novel,chr3:20284840-20290744
sample_6_Aligned.sortedByCoord.out,chr21,45892061,45900530,-,8,2,10,known,chr21:45892061-45900530
sample_6_Aligned.sortedByCoord.out,chr8,34656265,34665856,-,11,2,13,known,chr8:34656265-34665856
sample_6_Aligned.sortedByCoord.out,chr7,6556809,6561202,-,6,4,10,known,chr7:6556809-6561202
sample_6_Aligned.sortedByCoord.out,chr5,28563140,28571884,+,11,2,13,known,chr5:28563140-28571884
sample_6_Aligned.sortedByCoord.out,chr12,36399605,36408395,+,11,0,11,known,chr12:36399605-36408395
sample_6_Aligned.sortedByCoord.out,chr3,37236239,37237258,-,9,5,14,known,chr3:37236239-37237258
sample_6_Aligned.sortedByCoord.out,chr20,9419967,9429927,-,20,3,23,novel,chr20:9419967-9429927
sample_6_Aligned.sortedByCoord.out,chr4,20672037,20676937,-,13,3,16,known,chr4:20672037-20676937
sample_6_Aligned.sortedByCoord.out,chr17,29743099,29748744,+,9,3,12,novel,chr17:29743099-29748744
sample_6_Aligned.sortedByCoord.out,chr3,2175356,2176342,+,19,0,19,known,chr3:2175356-2176342
sample_6_Aligned.sortedByCoord.out,chr5,31812313,31817056,+,7,3,10,novel,chr5:31812313-31817056
sample_6_Aligned.sortedByCoord.out,chr4,33091842,33095772,-,4,3,7,known,chr4:33091842-33095772
sample_6_Aligned.sortedByCoord.out,chr8,28048531,28051236,-,11,1,12,known,chr8:28048531-28051236
sample_6_Aligned.sortedByCoord.out,chr13,12762063,12768652,-,8,1,9,known,chr13:12762063-12768652
sample_6_Aligned.sortedByCoord.out,chr4,7406280,7406397,-,13,3,16,known,chr4:7406280-7406397
sample_6_Aligned.sortedByCoord.out,chr4,38569320,38572240,-,8,2,10,known,chr4:38569320-38572240
sample_6_Aligned.sortedByCoord.out,chr1,24590782,24596942,-,13,0,13,known,chr1:24590782-24596942
sample_6_Aligned.sortedByCoord.out,chr1,22799066,22800821,+,9,2,11,known,chr1:22799066-22800821
sample_6_Aligned.sortedByCoord.out,chr7,46586705,46588149,-,7,4,11,known,chr7:46586705-46588149
sample_6_Aligned.sortedByCoord.out,chr22,13905478,13914989,+,11,1,12,known,chr22:13905478-13914989
sample_6_Aligned.sortedByCoord.out,chr5,9927840,9932395,-,9,1,10,known,chr5:9927840-9932395
sample_6_Aligned.sortedByCoord.out,chr9,4167805,4175442,+,16,1,17,known,chr9:4167805-4175442
sample_6_Aligned.sortedByCoord.out,chr10,33522777,33530333,+,12,2,14,known,chr10:33522777-33530333
sample_6_Aligned.sortedByCoord.out,chr8,5837819,5843689,-,17,6,23,known,chr8:5837819-5843689
sample_6_Aligned.sortedByCoord.out,chr7,22884196,22891317,+,6,4,10,known,chr7:22884196-22891317
sample_6_Aligned.sortedByCoord.out,chr15,46328554,46333960,-,24,5,29,novel,chr15:46328554-46333960
sample_6_Aligned.sortedByCoord.out,chr21,47555235,47557988,-,7,4,11,novel,chr21:47555235-47557988
sample_6_Aligned.sortedByCoord.out,chr8,29430117,29436275,+,11,2,13,novel,chr8:29430117-29436275
sample_6_Aligned.sortedByCoord.out,chr19,11396223,11405589,+,12,1,13,known,chr19:11396223-11405589
sample_6_Aligned.sortedByCoord.out,chr1,36347998,36348360,+,16,2,18,known,chr1:36347998-36348360
sample_6_Aligned.sortedByCoord.out,chr15,48947043,48949524,+,13,2,15,known,chr15:48947043-48949524
sample_6_Aligned.sortedByCoord.out,chr16,37789232,37795015,-,15,2,17,known,chr16:37789232-37795015
sample_6_Aligned.sortedByCoord.out,chr12,43587854,43591392,-,10,1,11,novel,chr12:43587854-43591392
sample_6_Aligned.sortedByCoord.out,chr18,26816129,26817314,+,11,0,11,known,chr18:26816129-26817314
sample_6_Aligned.sortedByCoord.out,chr12,13362745,13364482,-,10,2,12,known,chr12:13362745-13364482
sample_6_Aligned.sortedByCoord.out,chr1,30958881,30960910,-,10,0,10,known,chr1:30958881-30960910
sample_6_Aligned.sortedByCoord.out,chr8,7586601,7586866,-,10,2,12,known,chr8:7586601-7586866
sample_6_Aligned.sortedByCoord.out,chr5,45111309,45116745,-,8,2,10,novel,chr5:45111309-45116745
sample_6_Aligned.sortedByCoord.out,chr12,22461883,22469039,+,8,1,9,known,chr12:22461883-22469039
sample_6_Aligned.sortedByCoord.out,chr17,9956207,9956642,-,8,0,8,known,chr17:9956207-9956642
sample_6_Aligned.sortedByCoord.out,chr11,8174114,8183193,-,14,2,16,known,chr11:8174114-8183193
sample_6_Aligned.sortedByCoord.out,chr15,24900882,24908661,-,7,2,9,known,chr15:24900882-24908661
sample_6_Aligned.sortedByCoord.out,chr1,45868036,45871245,+,12,1,13,known,chr1:45868036-45871245
sample_6_Aligned.sortedByCoord.out,chr19,21469454,21472045,-,8,0,8,known,chr19:21469454-21472045
sample_6_Aligned.sortedByCoord.out,chr1,40620185,40621171,+,11,1,12,novel,chr1:40620185-40621171
sample_6_Aligned.sortedByCoord.out,chr13,35049569,35049951,+,11,2,13,known,chr13:35049569-35049951
sample_6_Aligned.sortedByCoord.out,chr15,36952833,36961146,+,14,2,16,known,chr15:36952833-36961146
sample_6_Aligned.sortedByCoord.out,chr5,40733603,40737187,+,6,2,8,known,chr5:40733603-40737187
sample_6_Aligned.sortedByCoord.out,chr1,6516130,6520385,+,3,1,4,known,chr1:6516130-6520385
sample_6_Aligned.sortedByCoord.out,chr17,40004817,40007190,-,10,0,10,known,chr17:40004817-40007190
sample_6_Aligned.sortedByCoord.out,chr13,47228399,47228557,+,8,0,8,novel,chr13:47228399-47228557
sample_6_Aligned.sortedByCoord.out,chr5,23019959,23020671,+,11,1,12,known,chr5:23019959-23020671
sample_6_Aligned.sortedByCoord.out,chr15,8120354,8125470,-,9,4,13,known,chr15:8120354-8125470
sample_6_Aligned.sortedByCoord.out,chr2,49568606,49570017,+,9,1,10,known,chr2:49568606-49570017
sample_6_Aligned.sortedByCoord.out,chr20,19366702,19372983,-,9,2,11,known,chr20:19366702-19372983
sample_6_Aligned.sortedByCoord.out,chr16,44656454,44664512,-,11,4,15,known,chr16:44656454-44664512
sample_6_Aligned.sortedByCoord.out,chr7,1748102,1755302,-,8,3,11,known,chr7:1748102-1755302
sample_6_Aligned.sortedByCoord.out,chr19,47170898,47175657,+,11,0,11,known,chr19:47170898-47175657
sample_6_Aligned.sortedByCoord.out,chr15,20965318,20972302,+,14,2,16,known,chr15:20965318-20972302
sample_6_Aligned.sortedByCoord.out,chr12,47839497,47843242,+,15,1,16,known,chr12:47839497-47843242
sample_6_Aligned.sortedByCoord.out,chr16,22862654,22865489,-,12,1,13,novel,chr16:22862654-22865489
sample_6_Aligned.sortedByCoord.out,chr5,27260517,27263568,-,10,1,11,known,chr5:27260517-27263568
sample_6_Aligned.sortedByCoord.out,chr12,18632850,18641282,-,7,3,10,known,chr12:18632850-18641282
sample_6_Aligned.sortedByCoord.out,chr18,22114400,22121167,+,7,5,12,known,chr18:22114400-22121167
sample_6_Aligned.sortedByCoord.out,chr5,12287450,12293613,+,7,3,10,known,chr5:12287450-12293613
sample_6_Aligned.sortedByCoord.out,chr13,41557631,41564326,+,7,3,10,known,chr13:41557631-41564326
sample_6_Aligned.sortedByCoord.out,chr13,34162402,34166209,-,6,4,10,known,chr13:34162402-34166209
sample_6_Aligned.sortedByCoord.out,chr6,16280441,16280994,-,9,1,10,known,chr6:16280441-16280994
sample_6_Aligned.sortedByCoord.out,chr6,49336697,49339955,-,11,0,11,known,chr6:49336697-49339955
sample_6_Aligned.sortedByCoord.out,chr22,18176844,18182971,+,6,3,9,novel,chr22:18176844-18182971
sample_6_Aligned.sortedByCoord.out,chr15,17944733,17951675,+,6,1,7,known,chr15:17944733-17951675
sample_6_Aligned.sortedByCoord.out,chr18,17426132,17435926,+,7,4,11,known,chr18:17426132-17435926
sample_6_Aligned.sortedByCoord.out,chr17,28486251,28489623,+,12,6,18,known,chr17:28486251-28489623
sample_6_Aligned.sortedByCoord.out,chr2,34130175,34135654,+,12,0,12,known,chr2:34130175-34135654
sample_6_Aligned.sortedByCoord.out,chr1,35045897,35047345,-,12,5,17,known,chr1:35045897-35047345
sample_6_Aligned.sortedByCoord.out,chr7,34146371,34153122,-,7,0,7,known,chr7:34146371-34153122
sample_6_Aligned.sortedByCoord.out,chr16,19162095,19170303,+,12,3,15,known,chr16:19162095-19170303
sample_6_Aligned.sortedByCoord.out,chr2,46179555,46181921,-,12,2,14,novel,chr2:46179555-46181921
sample_6_Aligned.sortedByCoord.out,chr7,13241725,13247776,+,7,1,8,novel,chr7:13241725-13247776
sample_6_Aligned.sortedByCoord.out,chr14,47598026,47598272,+,15,2,17,known,chr14:47598026-47598272
sample_6_Aligned.sortedByCoord.out,chr16,40134449,40136333,+,6,0,6,known,chr16:40134449-40136333
sample_6_Aligned.sortedByCoord.out,chr20,26022196,26028909,+,5,2,7,known,chr20:26022196-26028909
sample_6_Aligned.sortedByCoord.out,chr10,17964441,17965902,+,3,1,4,known,chr10:17964441-17965902
sample_6_Aligned.sortedByCoord.out,chr18,28426902,28434145,-,13,2,15,novel,chr18:28426902-28434145
sample_6_Aligned.sortedByCoord.out,chr1,37797972,37801962,-,10,1,11,known,chr1:37797972-37801962
sample_6_Aligned.sortedByCoord.out,chr14,8688591,8690043,+,12,2,14,known,chr14:8688591-8690043
sample_6_Aligned.sortedByCoord.out,chr19,18933316,18941487,+,17,0,17,known,chr19:18933316-18941487
sample_6_Aligned.sortedByCoord.out,chr14,21524353,21528958,-,12,2,14,known,chr14:21524353-21528958
sample_6_Aligned.sortedByCoord.out,chr19,16796044,16805763,+,11,2,13,known,chr19:16796044-16805763
sample_6_Aligned.sortedByCoord.out,chr16,42060218,42067782,+,10,2,12,known,chr16:42060218-42067782
sample_6_Aligned.sortedByCoord.out,chr9,10027304,10034403,+,12,1,13,known,chr9:10027304-10034403
sample_6_Aligned.sortedByCoord.out,chr11,7863024,7870400,-,11,1,12,novel,chr11:7863024-7870400
sample_6_Aligned.sortedByCoord.out,chr16,11927027,11931838,+,11,3,14,known,chr16:11927027-11931838
sample_6_Aligned.sortedByCoord.out,chr14,21002559,21008625,+,10,2,12,novel,chr14:21002559-21008625
sample_6_Aligned.sortedByCoord.out,chr8,21942202,21944205,-,15,4,19,known,chr8:21942202-21944205
sample_6_Aligned.sortedByCoord.out,chr9,13407793,13415349,-,8,0,8,known,chr9:13407793-13415349
sample_6_Aligned.sortedByCoord.out,chr22,25384399,25391529,+,5,2,7,known,chr22:25384399-25391529
sample_6_Aligned.sortedByCoord.out,chr9,25918485,25926727,-,6,1,7,known,chr9:25918485-25926727
sample_6_Aligned.sortedByCoord.out,chr21,25615167,25621319,+,5,2,7,known,chr21:25615167-25621319
sample_6_Aligned.sortedByCoord.out,chr18,12645158,12648942,+,9,1,10,known,chr18:12645158-12648942
sample_6_Aligned.sortedByCoord.out,chr2,15494580,15496164,-,8,4,12,known,chr2:15494580-15496164
sample_6_Aligned.sortedByCoord.out,chr21,23448566,23455570,+,12,0,12,known,chr21:23448566-23455570
sample_6_Aligned.sortedByCoord.out,chr21,1535030,1538209,+,3,2,5,known,chr21:1535030-1538209
sample_6_Aligned.sortedByCoord.out,chr14,42222698,42226805,+,13,1,14,known,chr14:42222698-42226805
sample_6_Aligned.sortedByCoord.out,chr4,45510431,45519855,+,6,2,8,known,chr4:45510431-45519855
sample_6_Aligned.sortedByCoord.out,chr13,39651468,39659427,+,9,3,12,known,chr13:39651468-39659427
sample_6_Aligned.sortedByCoord.out,chr21,24825554,24829762,-,9,2,11,known,chr21:24825554-24829762
sample_6_Aligned.sortedByCoord.out,chr3,30276874,30284578,-,6,0,6,known,chr3:30276874-30284578
sample_6_Aligned.sortedByCoord.out,chr4,48825555,48826405,-,11,2,13,known,chr4:48825555-48826405
sample_6_Aligned.sortedByCoord.out,chr3,49216577,49221870,-,14,1,15,known,chr3:49216577-49221870
sample_6_Aligned.sortedByCoord.out,chr7,26934281,26941024,-,5,0,5,novel,chr7:26934281-26941024
sample_6_Aligned.sortedByCoord.out,chr19,24179749,24188350,-,5,2,7,known,chr19:24179749-24188350
sample_6_Aligned.sortedByCoord.out,chr17,17412567,17421945,+,6,3,9,known,chr17:17412567-17421945
sample_6_Aligned.sortedByCoord.out,chr8,12666707,12671370,-,5,1,6,known,chr8:12666707-12671370
sample_6_Aligned.sortedByCoord.out,chr10,44533570,44539403,-,9,2,11,known,chr10:44533570-44539403
sample_6_Aligned.sortedByCoord.out,chr1,37242500,37244239,+,8,3,11,known,chr1:37242500-37244239
sample_6_Aligned.sortedByCoord.out,chr2,18106780,18116557,-,11,1,12,known,chr2:18106780-18116557
sample_6_Aligned.sortedByCoord.out,chr12,1502049,1504969,+,13,2,15,known,chr12:1502049-1504969
sample_6_Aligned.sortedByCoord.out,chr10,34496125,34498215,+,12,4,16,novel,chr10:34496125-34498215
sample_6_Aligned.sortedByCoord.out,chr18,21545845,21555328,+,15,0,15,known,chr18:21545845-21555328
sample_6_Aligned.sortedByCoord.out,chr9,14387888,14394051,-,8,0,8,known,chr9:14387888-14394051
sample_6_Aligned.sortedByCoord.out,chr13,11673133,11682942,+,9,0,9,known,chr13:11673133-11682942
sample_6_Aligned.sortedByCoord.out,chr19,22095324,22104439,+,8,2,10,known,chr19:22095324-22104439
sample_6_Aligned.sortedByCoord.out,chr20,29244176,29244871,+,10,2,12,known,chr20:29244176-29244871
sample_6_Aligned.sortedByCoord.out,chr17,39866155,39874712,-,11,0,11,known,chr17:39866155-39874712
sample_6_Aligned.sortedByCoord.out,chr22,31785700,31790006,-,5,1,6,novel,chr22:31785700-31790006
sample_6_Aligned.sortedByCoord.out,chr11,22762523,22771599,-,11,3,14,known,chr11:22762523-22771599
sample_6_Aligned.sortedByCoord.out,chr11,1973288,1980555,+,13,0,13,known,chr11:1973288-1980555
sample_6_Aligned.sortedByCoord.out,chr6,29662810,29668641,+,5,2,7,known,chr6:29662810-29668641
sample_6_Aligned.sortedByCoord.out,chr5,1210719,1218040,-,11,2,13,known,chr5:1210719-1218040
sample_6_Aligned.sortedByCoord.out,chr1,2585066,2593495,-,7,4,11,known,chr1:2585066-2593495
sample_6_Aligned.sortedByCoord.out,chr4,20773096,20776467,-,10,1,11,known,chr4:20773096-20776467
sample_6_Aligned.sortedByCoord.out,chr7,30050353,30059925,-,7,3,10,novel,chr7:30050353-30059925
sample_6_Aligned.sortedByCoord.out,chr11,1524908,1533251,-,13,2,15,known,chr11:1524908-1533251
sample_6_Aligned.sortedByCoord.out,chr22,16969056,16975897,-,15,2,17,known,chr22:16969056-16975897
sample_6_Aligned.sortedByCoord.out,chr21,2236923,2245457,+,11,1,12,known,chr21:2236923-2245457
sample_6_Aligned.sortedByCoord.out,chr15,44913105,44913388,+,14,2,16,known,chr15:44913105-44913388
sample_6_Aligned.sortedByCoord.out,chr10,31025412,31035367,-,11,2,13,known,chr10:31025412-31035367
sample_6_Aligned.sortedByCoord.out,chr9,33193586,33193712,-,8,3,11,novel,chr9:33193586-33193712
sample_6_Aligned.sortedByCoord.out,chr15,30508711,30512123,-,8,4,12,known,chr15:30508711-30512123
sample_6_Aligned.sortedByCoord.out,chr11,8978076,8984294,-,15,0,15,known,chr11:8978076-8984294
sample_6_Aligned.sortedByCoord.out,chr17,36953830,36963132,-,7,4,11,novel,chr17:36953830-36963132
sample_6_Aligned.sortedByCoord.out,chr22,40259396,40265410,+,6,2,8,novel,chr22:40259396-40265410
sample_6_Aligned.sortedByCoord.out,chr21,11696474,11700978,-,9,2,11,novel,chr21:11696474-11700978
sample_6_Aligned.sortedByCoord.out,chr5,36504290,36505694,-,11,1,12,known,chr5:36504290-36505694
sample_6_Aligned.sortedByCoord.out,chr20,6955189,6959147,+,8,3,11,novel,chr20:6955189-6959147
sample_6_Aligned.sortedByCoord.out,chr4,42121638,42125120,-,10,4,14,novel,chr4:42121638-42125120
sample_6_Aligned.sortedByCoord.out,chr15,40627476,40636454,-,14,5,19,known,chr15:40627476-40636454
sample_6_Aligned.sortedByCoord.out,chr22,23167454,23170288,-,10,4,14,known,chr22:23167454-23170288
sample_6_Aligned.sortedByCoord.out,chr22,36128482,36137710,-,12,2,14,known,chr22:36128482-36137710
sample_6_Aligned.sortedByCoord.out,chr5,7934176,7941942,-,14,2,16,known,chr5:7934176-7941942
sample_6_Aligned.sortedByCoord.out,chr2,44323442,44328427,+,9,1,10,known,chr2:44323442-44328427
sample_6_Aligned.sortedByCoord.out,chr20,44350724,44355735,-,9,1,10,known,chr20:44350724-44355735
sample_6_Aligned.sortedByCoord.out,chr5,16061948,16062119,+,7,1,8,known,chr5:16061948-16062119
sample_6_Aligned.sortedByCoord.out,chr15,49535669,49542458,+,13,1,14,known,chr15:49535669-49542458
sample_6_Aligned.sortedByCoord.out,chr15,1748059,1749808,-,7,1,8,known,chr15:1748059-1749808
sample_6_Aligned.sortedByCoord.out,chr20,24339453,24345096,+,11,4,15,novel,chr20:24339453-24345096
sample_6_Aligned.sortedByCoord.out,chr11,31987593,31988807,-,9,2,11,known,chr11:31987593-31988807
sample_6_Aligned.sortedByCoord.out,chr8,25701552,25706797,+,11,0,11,novel,chr8:25701552-25706797
sample_6_Aligned.sortedByCoord.out,chr17,22731681,22736602,+,8,3,11,novel,chr17:22731681-22736602
sample_6_Aligned.sortedByCoord.out,chr14,10597109,10601058,-,11,3,14,known,chr14:10597109-10601058
sample_6_Aligned.sortedByCoord.out,chr9,41910148,41914680,-,15,2,17,known,chr9:41910148-41914680
sample_6_Aligned.sortedByCoord.out,chr1,46029765,46032040,+,10,4,14,novel,chr1:46029765-46032040
sample_6_Aligned.sortedByCoord.out,chr8,7027429,7037332,-,16,0,16,known,chr8:7027429-7037332
sample_6_Aligned.sortedByCoord.out,chr12,23725472,23732686,+,7,3,10,known,chr12:23725472-23732686
sample_6_Aligned.sortedByCoord.out,chr6,13121956,13131914,-,13,2,15,known,chr6:13121956-13131914
sample_6_Aligned.sortedByCoord.out,chr3,2708745,2710082,+,9,4,13,known,chr3:2708745-2710082
sample_6_Aligned.sortedByCoord.out,chr1,29777584,29782962,-,9,2,11,known,chr1:29777584-29782962
sample_6_Aligned.sortedByCoord.out,chr5,29853464,29857902,+,18,0,18,known,chr5:29853464-29857902
sample_6_Aligned.sortedByCoord.out,chr6,39955503,39959567,+,15,6,21,known,chr6:39955503-39959567
sample_6_Aligned.sortedByCoord.out,chr3,18385924,18389590,+,13,1,14,known,chr3:18385924-18389590
sample_6_Aligned.sortedByCoord.out,chr3,44000799,44004955,+,8,3,11,known,chr3:44000799-44004955
sample_6_Aligned.sortedByCoord.out,chr5,37974147,37981674,+,7,3,10,known,chr5:37974147-37981674
sample_6_Aligned.sortedByCoord.out,chr15,7747866,7749208,+,11,0,11,known,chr15:7747866-7749208
sample_6_Aligned.sortedByCoord.out,chr3,35471010,35472720,+,11,1,12,novel,chr3:35471010-35472720
sample_6_Aligned.sortedByCoord.out,chr11,33983360,33989381,-,13,0,13,novel,chr11:33983360-33989381
sample_6_Aligned.sortedByCoord.out,chr5,6294035,6299029,-,11,0,11,known,chr5:6294035-6299029
sample_6_Aligned.sortedByCoord.out,chr8,27338444,27347353,-,8,3,11,known,chr8:27338444-27347353
sample_6_Aligned.sortedByCoord.out,chr18,26704439,26705285,+,16,2,18,known,chr18:26704439-26705285
sample_6_Aligned.sortedByCoord.out,chr2,29336928,29345435,-,14,1,15,known,chr2:29336928-29345435
sample_6_Aligned.sortedByCoord.out,chr15,10540037,10548690,+,11,2,13,known,chr15:10540037-10548690
sample_6_Aligned.sortedByCoord.out,chr8,7028546,7036406,-,7,2,9,novel,chr8:7028546-7036406
sample_6_Aligned.sortedByCoord.out,chr2,38737530,38738854,-,9,4,13,known,chr2:38737530-38738854
sample_6_Aligned.sortedByCoord.out,chr14,8323841,8332196,-,10,0,10,known,chr14:8323841-8332196
sample_6_Aligned.sortedByCoord.out,chr3,11329016,11337086,-,10,3,13,novel,chr3:11329016-11337086
sample_6_Aligned.sortedByCoord.out,chr19,8097062,8106480,-,7,2,9,known,chr19:8097062-8106480
sample_6_Aligned.sortedByCoord.out,chr15,12283036,12283934,-,9,1,10,known,chr15:12283036-12283934
sample_6_Aligned.sortedByCoord.out,chr9,48784461,48792836,+,6,0,6,known,chr9:48784461-48792836
sample_6_Aligned.sortedByCoord.out,chr16,11126954,11132738,-,13,3,16,known,chr16:11126954-11132738
sample_6_Aligned.sortedByCoord.out,chr17,42952478,42960794,+,7,2,9,known,chr17:42952478-42960794
sample_6_Aligned.sortedByCoord.out,chr3,15380269,15382007,+,7,3,10,known,chr3:15380269-15382007
sample_6_Aligned.sortedByCoord.out,chr22,43225445,43232667,+,10,0,10,known,chr22:43225445-43232667
sample_6_Aligned.sortedByCoord.out,chr3,10529337,10535941,+,16,2,18,known,chr3:10529337-10535941
sample_6_Aligned.sortedByCoord.out,chr11,18464536,18465347,-,9,0,9,known,chr11:18464536-18465347
sample_6_Aligned.sortedByCoord.out,chr4,44245156,44249839,-,11,4,15,known,chr4:44245156-44249839
sample_6_Aligned.sortedByCoord.out,chr7,15541319,15549101,-,11,2,13,known,chr7:15541319-15549101
sample_6_Aligned.sortedByCoord.out,chr22,27491955,27498165,+,11,2,13,known,chr22:27491955-27498165
sample_6_Aligned.sortedByCoord.out,chr21,31120991,31129710,-,11,1,12,known,chr21:31120991-31129710
sample_6_Aligned.sortedByCoord.out,chr17,35476195,35481852,+,18,3,21,novel,chr17:35476195-35481852
sample_6_Aligned.sortedByCoord.out,chr15,21887469,21887971,-,9,7,16,novel,chr15:21887469-21887971
sample_6_Aligned.sortedByCoord.out,chr15,33534925,33535573,+,8,1,9,known,chr15:33534925-33535573
sample_6_Aligned.sortedByCoord.out,chr6,45828019,45833621,-,11,2,13,known,chr6:45828019-45833621
sample_6_Aligned.sortedByCoord.out,chr11,47172057,47177428,-,13,2,15,novel,chr11:47172057-47177428
sample_6_Aligned.sortedByCoord.out,chr20,29433167,29437250,-,9,3,12,known,chr20:29433167-29437250
sample_6_Aligned.sortedByCoord.out,chr10,43252766,43258459,+,5,0,5,known,chr10:43252766-43258459
sample_6_Aligned.sortedByCoord.out,chr16,32363737,32366208,-,8,1,9,known,chr16:32363737-32366208
sample_6_Aligned.sortedByCoord.out,chr10,46089423,46097636,+,9,2,11,known,chr10:46089423-46097636
sample_6_Aligned.sortedByCoord.out,chr7,41509190,41517830,-,18,0,18,known,chr7:41509190-41517830
sample_6_Aligned.sortedByCoord.out,chr6,3373668,3377425,+,17,5,22,known,chr6:3373668-3377425
sample_6_Aligned.sortedByCoord.out,chr8,36248051,36250611,+,12,1,13,known,chr8:36248051-36250611
sample_6_Aligned.sortedByCoord.out,chr8,37518205,37524357,-,11,3,14,novel,chr8:37518205-37524357
sample_6_Aligned.sortedByCoord.out,chr9,1195956,1200045,+,8,1,9,known,chr9:1195956-1200045
sample_6_Aligned.sortedByCoord.out,chr4,24638361,24642490,+,9,1,10,known,chr4:24638361-24642490
sample_6_Aligned.sortedByCoord.out,chr16,20108705,20114504,-,7,1,8,known,chr16:20108705-20114504
sample_6_Aligned.sortedByCoord.out,chr19,10512226,10518489,-,8,2,10,novel,chr19:10512226-10518489
sample_6_Aligned.sortedByCoord.out,chr8,47760935,47765957,+,12,0,12,known,chr8:47760935-47765957
sample_6_Aligned.sortedByCoord.out,chr1,25802272,25807121,-,9,2,11,known,chr1:25802272-25807121
sample_6_Aligned.sortedByCoord.out,chr8,3907622,3913868,-,9,1,10,known,chr8:3907622-3913868
sample_6_Aligned.sortedByCoord.out,chr21,40394598,40399991,-,14,3,17,known,chr21:40394598-40399991
sample_6_Aligned.sortedByCoord.out,chr13,35897839,35906150,-,9,3,12,known,chr13:35897839-35906150
sample_6_Aligned.sortedByCoord.out,chr6,32774510,32784388,+,7,4,11,known,chr6:32774510-32784388
sample_6_Aligned.sortedByCoord.out,chr4,11109364,11110316,-,14,1,15,known,chr4:11109364-11110316
sample_6_Aligned.sortedByCoord.out,chr20,30450977,30459910,+,7,1,8,known,chr20:30450977-30459910
sample_6_Aligned.sortedByCoord.out,chr18,25665363,25675207,+,13,0,13,known,chr18:25665363-25675207
sample_6_Aligned.sortedByCoord.out,chr9,9399047,9407954,-,11,1,12,known,chr9:9399047-9407954
sample_6_Aligned.sortedByCoord.out,chr16,46900178,46909399,-,11,1,12,known,chr16:46900178-46909399
sample_6_Aligned.sortedByCoord.out,chr13,47105219,47106652,+,10,1,11,novel,chr13:47105219-47106652
sample_6_Aligned.sortedByCoord.out,chr22,16140396,16145794,+,12,4,16,known,chr22:16140396-16145794
sample_6_Aligned.sortedByCoord.out,chr6,47044008,47050647,+,9,2,11,known,chr6:47044008-47050647
sample_6_Aligned.sortedByCoord.out,chr2,48632368,48632535,-,12,2,14,known,chr2:48632368-48632535
sample_6_Aligned.sortedByCoord.out,chr19,20435676,20444943,+,6,2,8,known,chr19:20435676-20444943
sample_6_Aligned.sortedByCoord.out,chr19,23619109,23622074,-,8,1,9,known,chr19:23619109-23622074
sample_6_Aligned.sortedByCoord.out,chr4,44982151,44991458,-,11,4,15,known,chr4:44982151-44991458
sample_6_Aligned.sortedByCoord.out,chr14,46800704,46805028,-,14,2,16,known,chr14:46800704-46805028
sample_6_Aligned.sortedByCoord.out,chr1,23062211,23071693,-,6,2,8,known,chr1:23062211-23071693
sample_6_Aligned.sortedByCoord.out,chr16,38894714,38901324,+,9,3,12,known,chr16:38894714-38901324
sample_6_Aligned.sortedByCoord.out,chr14,29597009,29600348,+,12,2,14,known,chr14:29597009-29600348
sample_6_Aligned.sortedByCoord.out,chr9,24780798,24782798,-,16,2,18,known,chr9:24780798-24782798
sample_6_Aligned.sortedByCoord.out,chr16,23763216,23769932,+,9,3,12,known,chr16:23763216-23769932
sample_6_Aligned.sortedByCoord.out,chr2,24518545,24528422,+,11,4,15,known,chr2:24518545-24528422
sample_6_Aligned.sortedByCoord.out,chr14,30840674,30846278,-,14,4,18,novel,chr14:30840674-30846278
sample_6_Aligned.sortedByCoord.out,chr7,46001707,46003105,-,10,0,10,known,chr7:46001707-46003105
sample_6_Aligned.sortedByCoord.out,chr9,15033311,15040496,+,11,0,11,known,chr9:15033311-15040496
sample_6_Aligned.sortedByCoord.out,chr16,41749424,41754495,+,11,3,14,known,chr16:41749424-41754495
sample_6_Aligned.sortedByCoord.out,chr6,44420709,44421931,+,12,3,15,known,chr6:44420709-44421931
sample_6_Aligned.sortedByCoord.out,chr21,25478518,25485851,+,5,1,6,novel,chr21:25478518-25485851
sample_6_Aligned.sortedByCoord.out,chr19,27234985,27237849,+,11,1,12,known,chr19:27234985-27237849
sample_6_Aligned.sortedByCoord.out,chr3,42894924,42900578,+,13,2,15,known,chr3:42894924-42900578
sample_6_Aligned.sortedByCoord.out,chr15,33817331,33826098,+,13,1,14,known,chr15:33817331-33826098
sample_6_Aligned.sortedByCoord.out,chr6,22739278,22747375,-,19,1,20,known,chr6:22739278-22747375
sample_6_Aligned.sortedByCoord.out,chr9,15963988,15972110,-,10,2,12,known,chr9:15963988-15972110
sample_6_Aligned.sortedByCoord.out,chr17,45207488,45209498,-,7,1,8,known,chr17:45207488-45209498
sample_6_Aligned.sortedByCoord.out,chr14,11004108,11011953,+,5,3,8,known,chr14:11004108-11011953
sample_6_Aligned.sortedByCoord.out,chr11,31408001,31409901,+,10,3,13,novel,chr11:31408001-31409901
sample_6_Aligned.sortedByCoord.out,chr2,14027594,14030918,+,9,4,13,known,chr2:14027594-14030918
sample_6_Aligned.sortedByCoord.out,chr9,38960682,38964353,+,10,1,11,known,chr9:38960682-38964353
sample_6_Aligned.sortedByCoord.out,chr14,47523963,47530987,+,11,1,12,known,chr14:47523963-47530987
sample_6_Aligned.sortedByCoord.out,chr19,19568250,19571033,-,11,2,13,novel,chr19:19568250-19571033
sample_6_Aligned.sortedByCoord.out,chr11,2167396,2169299,+,7,1,8,known,chr11:2167396-2169299
sample_6_Aligned.sortedByCoord.out,chr15,43394566,43397779,+,9,2,11,known,chr15:43394566-43397779
sample_6_Aligned.sortedByCoord.out,chr5,7962907,7969392,-,10,3,13,known,chr5:7962907-7969392
sample_6_Aligned.sortedByCoord.out,chr2,27480461,27488255,-,10,1,11,known,chr2:27480461-27488255
sample_6_Aligned.sortedByCoord.out,chr3,35008453,35012027,+,8,1,9,known,chr3:35008453-35012027
sample_6_Aligned.sortedByCoord.out,chr21,18891823,18897650,+,6,1,7,known,chr21:18891823-18897650
sample_6_Aligned.sortedByCoord.out,chr2,42368423,42375186,-,12,1,13,novel,chr2:42368423-42375186
sample_6_Aligned.sortedByCoord.out,chr17,6017763,6020443,+,6,4,10,known,chr17:6017763-6020443
sample_6_Aligned.sortedByCoord.out,chr20,33736724,33742527,+,13,3,16,known,chr20:33736724-33742527
sample_6_Aligned.sortedByCoord.out,chr2,2370262,2370574,-,10,3,13,known,chr2:2370262-2370574
sample_6_Aligned.sortedByCoord.out,chr17,2952865,2955915,+,8,1,9,known,chr17:2952865-2955915
sample_6_Aligned.sortedByCoord.out,chr7,30724587,30733709,+,7,3,10,known,chr7:30724587-30733709
sample_6_Aligned.sortedByCoord.out,chr20,2231249,2232912,-,5,0,5,known,chr20:2231249-2232912
sample_6_Aligned.sortedByCoord.out,chr5,33662230,33662517,-,8,2,10,novel,chr5:33662230-33662517
sample_6_Aligned.sortedByCoord.out,chr1,1580288,1582914,-,5,3,8,known,chr1:1580288-1582914
sample_6_Aligned.sortedByCoord.out,chr4,34292579,34300795,+,9,3,12,known,chr4:34292579-34300795
sample_6_Aligned.sortedByCoord.out,chr8,12293503,12299629,-,2,2,4,known,chr8:12293503-12299629
sample_6_Aligned.sortedByCoord.out,chr16,18927465,18931534,+,15,3,18,known,chr16:18927465-18931534
sample_6_Aligned.sortedByCoord.out,chr15,16169077,16172060,-,8,2,10,known,chr15:16169077-16172060
sample_6_Aligned.sortedByCoord.out,chr10,37816704,37821539,-,12,2,14,novel,chr10:37816704-37821539
sample_6_Aligned.sortedByCoord.out,chr8,34270854,34276655,-,6,1,7,novel,chr8:34270854-34276655
sample_6_Aligned.sortedByCoord.out,chr10,6805323,6812072,-,16,1,17,novel,chr10:6805323-6812072
sample_6_Aligned.sortedByCoord.out,chr17,6486777,6490253,+,8,1,9,known,chr17:6486777-6490253
sample_6_Aligned.sortedByCoord.out,chr3,33363664,33366711,-,11,1,12,known,chr3:33363664-33366711
sample_6_Aligned.sortedByCoord.out,chr11,26591159,26599588,+,5,4,9,novel,chr11:26591159-26599588
sample_6_Aligned.sortedByCoord.out,chr6,17596998,17601210,-,11,1,12,known,chr6:17596998-17601210
sample_6_Aligned.sortedByCoord.out,chr3,28876096,28878251,-,5,1,6,known,chr3:28876096-28878251
sample_6_Aligned.sortedByCoord.out,chr13,22361515,22366235,+,10,6,16,novel,chr13:22361515-22366235
sample_6_Aligned.sortedByCoord.out,chr7,3691463,3698625,+,8,2,10,known,chr7:3691463-3698625
sample_6_Aligned.sortedByCoord.out,chr8,1185874,1193672,+,8,4,12,known,chr8:1185874-1193672
sample_6_Aligned.sortedByCoord.out,chr19,34184010,34185647,-,9,3,12,known,chr19:34184010-34185647
sample_6_Aligned.sortedByCoord.out,chr10,12690256,12699503,+,14,2,16,known,chr10:12690256-12699503
sample_6_Aligned.sortedByCoord.out,chr1,24663579,24667540,+,8,4,12,known,chr1:24663579-24667540
sample_6_Aligned.sortedByCoord.out,chr18,28932010,28940332,-,8,2,10,known,chr18:28932010-28940332
sample_6_Aligned.sortedByCoord.out,chr1,49473892,49482617,+,11,3,14,novel,chr1:49473892-49482617
sample_6_Aligned.sortedByCoord.out,chr19,27010859,27018830,-,10,1,11,known,chr19:27010859-27018830
sample_6_Aligned.sortedByCoord.out,chr9,21131826,21132715,+,14,1,15,known,chr9:21131826-21132715
sample_6_Aligned.sortedByCoord.out,chr22,11681389,11683810,+,13,2,15,known,chr22:11681389-11683810
sample_6_Aligned.sortedByCoord.out,chr12,33754157,33755839,-,7,1,8,known,chr12:33754157-33755839
sample_6_Aligned.sortedByCoord.out,chr2,16337200,16339271,+,12,2,14,known,chr2:16337200-16339271
sample_6_Aligned.sortedByCoord.out,chr12,18387475,18394237,-,10,0,10,known,chr12:18387475-18394237
sample_6_Aligned.sortedByCoord.out,chr14,15071471,15074754,-,9,2,11,known,chr14:15071471-15074754
sample_6_Aligned.sortedByCoord.out,chr21,27168182,27173896,-,11,3,14,known,chr21:27168182-27173896
sample_6_Aligned.sortedByCoord.out,chr6,18709929,18715226,+,12,1,13,novel,chr6:18709929-18715226
sample_6_Aligned.sortedByCoord.out,chr16,41405592,41413478,-,12,2,14,novel,chr16:41405592-41413478
sample_6_Aligned.sortedByCoord.out,chr4,35974175,35977925,+,9,3,12,known,chr4:35974175-35977925
sample_6_Aligned.sortedByCoord.out,chr21,18849637,18851952,-,9,5,14,known,chr21:18849637-18851952
sample_6_Aligned.sortedByCoord.out,chr10,9859119,9865338,+,9,1,10,novel,chr10:9859119-9865338
sample_6_Aligned.sortedByCoord.out,chr17,35397484,35405840,+,9,5,14,novel,chr17:35397484-35405840
sample_6_Aligned.sortedByCoord.out,chr11,44890010,44897114,+,13,1,14,known,chr11:44890010-44897114
sample_6_Aligned.sortedByCoord.out,chr19,6028887,6032580,+,9,0,9,novel,chr19:6028887-6032580
sample_6_Aligned.sortedByCoord.out,chr19,6289433,6293172,-,10,2,12,known,chr19:6289433-6293172
sample_6_Aligned.sortedByCoord.out,chr13,40793458,40801308,+,9,2,11,known,chr13:40793458-40801308
sample_6_Aligned.sortedByCoord.out,chr17,25076849,25081228,+,9,3,12,known,chr17:25076849-25081228
sample_6_Aligned.sortedByCoord.out,chr11,18065309,18073930,-,7,3,10,known,chr11:18065309-18073930
sample_6_Aligned.sortedByCoord.out,chr2,45923496,45926821,+,10,2,12,known,chr2:45923496-45926821
sample_6_Aligned.sortedByCoord.out,chr20,49455096,49460783,-,8,1,9,known,chr20:49455096-49460783
sample_6_Aligned.sortedByCoord.out,chr9,6446842,6454700,+,11,2,13,known,chr9:6446842-6454700
sample_6_Aligned.sortedByCoord.out,chr8,16107831,16115450,-,13,3,16,known,chr8:16107831-16115450
sample_6_Aligned.sortedByCoord.out,chr15,27951612,27960584,-,18,0,18,known,chr15:27951612-27960584
sample_6_Aligned.sortedByCoord.out,chr20,45569450,45576045,-,6,2,8,known,chr20:45569450-45576045
sample_6_Aligned.sortedByCoord.out,chr9,23128371,23134716,+,5,0,5,novel,chr9:23128371-23134716
sample_6_Aligned.sortedByCoord.out,chr14,1142643,1151553,+,7,2,9,known,chr14:1142643-1151553
sample_6_Aligned.sortedByCoord.out,chr7,13628290,13636166,-,16,5,21,known,chr7:13628290-13636166
sample_6_Aligned.sortedByCoord.out,chr18,25557360,25560431,+,10,3,13,known,chr18:25557360-25560431
sample_6_Aligned.sortedByCoord.out,chr15,10430283,10430867,+,13,2,15,known,chr15:10430283-10430867
sample_6_Aligned.sortedByCoord.out,chr5,39899577,39905111,-,9,1,10,known,chr5:39899577-39905111
sample_6_Aligned.sortedByCoord.out,chr14,39830165,39837316,-,13,1,14,known,chr14:39830165-39837316
sample_6_Aligned.sortedByCoord.out,chr6,45889585,45896327,-,6,2,8,known,chr6:45889585-45896327
sample_6_Aligned.sortedByCoord.out,chr21,1384488,1391184,+,5,1,6,novel,chr21:1384488-1391184
sample_6_Aligned.sortedByCoord.out,chr15,18987870,18990025,-,8,3,11,known,chr15:18987870-18990025
sample_6_Aligned.sortedByCoord.out,chr18,9507235,9511604,-,11,2,13,novel,chr18:9507235-9511604
sample_6_Aligned.sortedByCoord.out,chr3,48783648,48791626,-,13,2,15,novel,chr3:48783648-48791626
sample_6_Aligned.sortedByCoord.out,chr8,8221475,8228950,-,11,4,15,known,chr8:8221475-8228950
sample_6_Aligned.sortedByCoord.out,chr11,26820002,26829251,-,14,1,15,novel,chr11:26820002-26829251
sample_6_Aligned.sortedByCoord.out,chr11,15953134,15960435,+,5,1,6,novel,chr11:15953134-15960435
sample_6_Aligned.sortedByCoord.out,chr8,21477004,21483208,+,14,2,16,known,chr8:21477004-21483208
sample_6_Aligned.sortedByCoord.out,chr10,34725378,34734192,+,11,2,13,known,chr10:34725378-34734192
sample_6_Aligned.sortedByCoord.out,chr10,2599568,2599995,+,13,2,15,known,chr10:2599568-2599995
sample_6_Aligned.sortedByCoord.out,chr12,43965595,43970214,-,10,1,11,novel,chr12:43965595-43970214
sample_6_Aligned.sortedByCoord.out,chr1,38305395,38307554,+,11,5,16,known,chr1:38305395-38307554
sample_6_Aligned.sortedByCoord.out,chr18,30678817,30683471,+,10,2,12,known,chr18:30678817-30683471
sample_6_Aligned.sortedByCoord.out,chr1,23063781,23073231,+,13,3,16,known,chr1:23063781-23073231
sample_6_Aligned.sortedByCoord.out,chr22,4474882,4484069,+,11,2,13,known,chr22:4474882-4484069
sample_6_Aligned.sortedByCoord.out,chr17,47212551,47219230,+,7,4,11,known,chr17:47212551-47219230
sample_6_Aligned.sortedByCoord.out,chr16,14283460,14284719,-,12,3,15,known,chr16:14283460-14284719
sample_6_Aligned.sortedByCoord.out,chr21,18689660,18691261,-,8,3,11,novel,chr21:18689660-18691261
sample_6_Aligned.sortedByCoord.out,chr6,18481646,18482769,+,9,4,13,novel,chr6:18481646-18482769
sample_6_Aligned.sortedByCoord.out,chr16,45571529,45576123,+,9,6,15,known,chr16:45571529-45576123
sample_6_Aligned.sortedByCoord.out,chr2,38106897,38108437,+,7,1,8,known,chr2:38106897-38108437
sample_6_Aligned.sortedByCoord.out,chr5,42159888,42164304,-,6,2,8,known,chr5:42159888-42164304
sample_6_Aligned.sortedByCoord.out,chr7,4958565,4960001,-,13,2,15,known,chr7:4958565-4960001
sample_6_Aligned.sortedByCoord.out,chr6,9726184,9734586,+,12,3,15,novel,chr6:9726184-9734586
sample_6_Aligned.sortedByCoord.out,chr3,6306129,6307597,+,11,2,13,known,chr3:6306129-6307597
sample_6_Aligned.sortedByCoord.out,chr1,37885489,37891074,-,12,2,14,known,chr1:37885489-37891074
sample_6_Aligned.sortedByCoord.out,chr1,25068658,25074872,+,10,5,15,known,chr1:25068658-25074872
sample_6_Aligned.sortedByCoord.out,chr4,42205774,42214194,-,11,3,14,known,chr4:42205774-42214194
sample_6_Aligned.sortedByCoord.out,chr7,21983073,21992991,-,11,1,12,known,chr7:21983073-21992991
sample_6_Aligned.sortedByCoord.out,chr22,29007379,29015348,-,9,5,14,known,chr22:29007379-29015348
sample_6_Aligned.sortedByCoord.out,chr16,10596212,10604127,+,5,1,6,known,chr16:10596212-10604127
sample_6_Aligned.sortedByCoord.out,chr14,26984394,26986102,+,10,2,12,known,chr14:26984394-26986102
sample_6_Aligned.sortedByCoord.out,chr13,7691902,7697114,-,7,4,11,known,chr13:7691902-7697114
sample_6_Aligned.sortedByCoord.out,chr14,31270274,31272238,-,5,0,5,known,chr14:31270274-31272238
sample_6_Aligned.sortedByCoord.out,chr10,11476035,11477602,+,14,4,18,known,chr10:11476035-11477602
sample_6_Aligned.sortedByCoord.out,chr3,19983013,19984312,-,13,0,13,known,chr3:19983013-19984312
sample_6_Aligned.sortedByCoord.out,chr10,14889613,14893824,+,10,2,12,novel,chr10:14889613-14893824
sample_6_Aligned.sortedByCoord.out,chr19,34501138,34508755,-,15,1,16,known,chr19:34501138-34508755
sample_6_Aligned.sortedByCoord.out,chr4,15014950,15017875,+,4,2,6,novel,chr4:15014950-15017875
sample_6_Aligned.sortedByCoord.out,chr8,10636937,10646042,+,7,4,11,known,chr8:10636937-10646042
sample_6_Aligned.sortedByCoord.out,chr22,12644528,12653215,+,12,1,13,known,chr22:12644528-12653215
sample_6_Aligned.sortedByCoord.out,chr8,14525390,14527823,-,7,4,11,known,chr8:14525390-14527823
sample_6_Aligned.sortedByCoord.out,chr9,21458585,21467815,-,4,3,7,novel,chr9:21458585-21467815
sample_6_Aligned.sortedByCoord.out,chr15,17230588,17233126,-,15,3,18,known,chr15:17230588-17233126
sample_6_Aligned.sortedByCoord.out,chr4,22118754,22124306,-,12,2,14,known,chr4:22118754-22124306
sample_6_Aligned.sortedByCoord.out,chr14,4016066,4025759,-,10,1,11,known,chr14:4016066-4025759
sample_6_Aligned.sortedByCoord.out,chr3,18997548,18999789,+,12,3,15,known,chr3:18997548-18999789
sample_6_Aligned.sortedByCoord.out,chr7,35951633,35958799,+,18,0,18,known,chr7:35951633-35958799
sample_6_Aligned.sortedByCoord.out,chr9,18811248,18820882,+,9,0,9,known,chr9:18811248-18820882
sample_6_Aligned.sortedByCoord.out,chr8,37252711,37261032,+,8,2,10,known,chr8:37252711-37261032
sample_6_Aligned.sortedByCoord.out,chr19,19691243,19693512,-,12,1,13,novel,chr19:19691243-19693512
sample_6_Aligned.sortedByCoord.out,chr8,24197483,24204602,+,10,3,13,known,chr8:24197483-24204602
sample_6_Aligned.sortedByCoord.out,chr18,24931302,24937495,+,12,1,13,known,chr18:24931302-24937495
sample_6_Aligned.sortedByCoord.out,chr11,35820659,35825212,+,14,1,15,known,chr11:35820659-35825212
sample_6_Aligned.sortedByCoord.out,chr15,18579593,18583634,+,10,0,10,known,chr15:18579593-18583634
sample_6_Aligned.sortedByCoord.out,chr3,47316484,47319285,-,10,2,12,known,chr3:47316484-47319285
sample_6_Aligned.sortedByCoord.out,chr12,34515692,34516822,-,7,1,8,known,chr12:34515692-34516822
sample_6_Aligned.sortedByCoord.out,chr1,46200417,46201107,+,5,3,8,novel,chr1:46200417-46201107
sample_6_Aligned.sortedByCoord.out,chr21,22889521,22895318,+,8,0,8,known,chr21:22889521-22895318
sample_6_Aligned.sortedByCoord.out,chr7,17470925,17478413,-,8,1,9,known,chr7:17470925-17478413
sample_6_Aligned.sortedByCoord.out,chr22,13238746,13244113,+,14,2,16,novel,chr22:13238746-13244113
sample_6_Aligned.sortedByCoord.out,chr5,40752578,40752805,+,10,4,14,known,chr5:40752578-40752805
sample_6_Aligned.sortedByCoord.out,chr19,46481415,46484578,-,5,3,8,novel,chr19:46481415-46484578
sample_6_Aligned.sortedByCoord.out,chr18,44772468,44780182,+,13,1,14,novel,chr18:44772468-44780182
sample_6_Aligned.sortedByCoord.out,chr16,23591210,23593639,+,11,0,11,known,chr16:23591210-23593639
sample_6_Aligned.sortedByCoord.out,chr5,46203811,46206871,-,10,5,15,novel,chr5:46203811-46206871
sample_6_Aligned.sortedByCoord.out,chr4,13562672,13563296,+,9,1,10,known,chr4:13562672-13563296
sample_6_Aligned.sortedByCoord.out,chr16,40827761,40836562,-,9,1,10,known,chr16:40827761-40836562
sample_6_Aligned.sortedByCoord.out,chr14,19595645,19599320,+,10,2,12,known,chr14:19595645-19599320
sample_6_Aligned.sortedByCoord.out,chr8,11552250,11560600,-,10,3,13,known,chr8:11552250-11560600
sample_6_Aligned.sortedByCoord.out,chr19,9591738,9595096,-,5,1,6,known,chr19:9591738-9595096
sample_6_Aligned.sortedByCoord.out,chr16,41861769,41870200,-,12,5,17,known,chr16:41861769-41870200
sample_6_Aligned.sortedByCoord.out,chr1,33260729,33264833,+,6,1,7,known,chr1:33260729-33264833
sample_6_Aligned.sortedByCoord.out,chr14,39566977,39573010,+,13,2,15,known,chr14:39566977-39573010
sample_6_Aligned.sortedByCoord.out,chr19,36878898,36879668,+,10,3,13,known,chr19:36878898-36879668
sample_6_Aligned.sortedByCoord.out,chr7,13406890,13408225,-,8,1,9,known,chr7:13406890-13408225
sample_6_Aligned.sortedByCoord.out,chr6,12577941,12583159,-,11,4,15,known,chr6:12577941-12583159
sample_6_Aligned.sortedByCoord.out,chr11,5582872,5591198,+,7,1,8,known,chr11:5582872-5591198
sample_6_Aligned.sortedByCoord.out,chr1,45147444,45150872,+,14,2,16,novel,chr1:45147444-45150872
sample_6_Aligned.sortedByCoord.out,chr14,12862973,12864788,+,10,1,11,known,chr14:12862973-12864788
sample_6_Aligned.sortedByCoord.out,chr3,4372107,4380645,-,5,2,7,known,chr3:4372107-4380645
sample_6_Aligned.sortedByCoord.out,chr13,29362304,29367433,+,6,1,7,known,chr13:29362304-29367433
sample_6_Aligned.sortedByCoord.out,chr12,3210190,3215113,-,10,0,10,known,chr12:3210190-3215113
sample_6_Aligned.sortedByCoord.out,chr12,46096250,46102377,-,9,2,11,novel,chr12:46096250-46102377
sample_6_Aligned.sortedByCoord.out,chr4,46103182,46108274,-,12,3,15,known,chr4:46103182-46108274
sample_6_Aligned.sortedByCoord.out,chr21,46026455,46029932,+,10,1,11,known,chr21:46026455-46029932
sample_6_Aligned.sortedByCoord.out,chr8,42978802,42988216,+,10,3,13,known,chr8:42978802-42988216
sample_6_Aligned.sortedByCoord.out,chr22,19064184,19066180,+,10,1,11,novel,chr22:19064184-19066180
sample_6_Aligned.sortedByCoord.out,chr2,44610656,44611053,+,8,0,8,novel,chr2:44610656-44611053
sample_6_Aligned.sortedByCoord.out,chr13,13963163,13971112,+,13,5,18,known,chr13:13963163-13971112
sample_6_Aligned.sortedByCoord.out,chr10,41149715,41153674,-,13,0,13,known,chr10:41149715-41153674
sample_6_Aligned.sortedByCoord.out,chr8,1661749,1665453,-,11,4,15,known,chr8:1661749-1665453
sample_6_Aligned.sortedByCoord.out,chr18,39597717,39598711,-,9,1,10,known,chr18:39597717-39598711
sample_6_Aligned.sortedByCoord.out,chr14,40434462,40438678,-,9,2,11,known,chr14:40434462-40438678
sample_6_Aligned.sortedByCoord.out,chr2,38414165,38417612,+,7,1,8,known,chr2:38414165-38417612
sample_6_Aligned.sortedByCoord.out,chr6,13157172,13159691,-,7,1,8,novel,chr6:13157172-13159691
sample_6_Aligned.sortedByCoord.out,chr6,41930340,41931170,-,15,0,15,novel,chr6:41930340-41931170
sample_6_Aligned.sortedByCoord.out,chr14,32942539,32943778,+,13,4,17,known,chr14:32942539-32943778
sample_6_Aligned.sortedByCoord.out,chr2,20964437,20964840,+,9,2,11,known,chr2:20964437-20964840
sample_6_Aligned.sortedByCoord.out,chr21,27070859,27075241,-,9,1,10,known,chr21:27070859-27075241
sample_6_Aligned.sortedByCoord.out,chr13,43278381,43281200,-,13,1,14,known,chr13:43278381-43281200
sample_6_Aligned.sortedByCoord.out,chr7,14217997,14221101,+,11,1,12,known,chr7:14217997-14221101
sample_6_Aligned.sortedByCoord.out,chr10,45262358,45269378,+,8,0,8,novel,chr10:45262358-45269378
sample_6_Aligned.sortedByCoord.out,chr1,45261089,45269295,-,8,1,9,known,chr1:45261089-45269295
sample_6_Aligned.sortedByCoord.out,chr10,26706606,26709320,+,8,3,11,known,chr10:26706606-26709320
sample_6_Aligned.sortedByCoord.out,chr5,43792420,43794185,+,16,1,17,novel,chr5:43792420-43794185
sample_6_Aligned.sortedByCoord.out,chr22,12367703,12372800,+,14,3,17,known,chr22:12367703-12372800
sample_6_Aligned.sortedByCoord.out,chr7,37321647,37329479,+,10,2,12,known,chr7:37321647-37329479
sample_6_Aligned.sortedByCoord.out,chr14,41609681,41617063,-,8,2,10,known,chr14:41609681-41617063
sample_6_Aligned.sortedByCoord.out,chr14,17904480,17911731,+,10,1,11,known,chr14:17904480-17911731
sample_6_Aligned.sortedByCoord.out,chr15,23849255,23849757,+,17,6,23,known,chr15:23849255-23849757
sample_6_Aligned.sortedByCoord.out,chr12,41728654,41737294,+,14,2,16,known,chr12:41728654-41737294
sample_6_Aligned.sortedByCoord.out,chr6,37461867,37470953,+,6,3,9,known,chr6:37461867-37470953
sample_6_Aligned.sortedByCoord.out,chr16,1679658,1682246,-,8,0,8,known,chr16:1679658-1682246
sample_6_Aligned.sortedByCoord.out,chr20,45649291,45652138,-,9,3,12,known,chr20:45649291-45652138
sample_6_Aligned.sortedByCoord.out,chr12,22473268,22480047,-,9,2,11,known,chr12:22473268-22480047
sample_6_Aligned.sortedByCoord.out,chr8,3063901,3065708,+,7,3,10,known,chr8:3063901-3065708
sample_6_Aligned.sortedByCoord.out,chr15,3560306,3567967,-,8,1,9,known,chr15:3560306-3567967
sample_6_Aligned.sortedByCoord.out,chr16,34324104,34329683,-,13,2,15,known,chr16:34324104-34329683
sample_6_Aligned.sortedByCoord.out,chr17,25702041,25706921,-,8,0,8,known,chr17:25702041-25706921
sample_6_Aligned.sortedByCoord.out,chr22,49255044,49258980,+,4,1,5,known,chr22:49255044-49258980
sample_6_Aligned.sortedByCoord.out,chr6,29406450,29413307,-,9,1,10,novel,chr6:29406450-29413307
sample_6_Aligned.sortedByCoord.out,chr12,17466205,17476103,+,6,1,7,known,chr12:17466205-17476103
sample_6_Aligned.sortedByCoord.out,chr4,8193088,8194263,-,10,2,12,novel,chr4:8193088-8194263
sample_6_Aligned.sortedByCoord.out,chr14,38695428,38699124,-,8,2,10,known,chr14:38695428-38699124
sample_6_Aligned.sortedByCoord.out,chr5,23177199,23184223,+,7,2,9,novel,chr5:23177199-23184223
sample_6_Aligned.sortedByCoord.out,chr12,42610597,42618585,+,9,2,11,known,chr12:42610597-42618585
sample_6_Aligned.sortedByCoord.out,chr22,45295735,45302407,-,8,1,9,novel,chr22:45295735-45302407
sample_6_Aligned.sortedByCoord.out,chr19,12306170,12307236,+,10,3,13,known,chr19:12306170-12307236
sample_6_Aligned.sortedByCoord.out,chr13,32557263,32565679,+,12,5,17,known,chr13:32557263-32565679
sample_6_Aligned.sortedByCoord.out,chr18,44106217,44114340,-,6,5,11,known,chr18:44106217-44114340
sample_6_Aligned.sortedByCoord.out,chr15,31337772,31344651,-,8,3,11,known,chr15:31337772-31344651
sample_6_Aligned.sortedByCoord.out,chr2,49037495,49039695,+,8,3,11,known,chr2:49037495-49039695
sample_6_Aligned.sortedByCoord.out,chr1,16874633,16881967,+,14,3,17,known,chr1:16874633-16881967
sample_6_Aligned.sortedByCoord.out,chr4,8435110,8438469,+,6,4,10,known,chr4:8435110-8438469
sample_6_Aligned.sortedByCoord.out,chr11,27563112,27569581,-,10,1,11,novel,chr11:27563112-27569581
sample_6_Aligned.sortedByCoord.out,chr13,30324753,30332397,-,6,1,7,known,chr13:30324753-30332397
sample_6_Aligned.sortedByCoord.out,chr2,9668202,9670918,-,8,3,11,known,chr2:9668202-9670918
sample_6_Aligned.sortedByCoord.out,chr8,4857536,4864109,+,8,4,12,novel,chr8:4857536-4864109
sample_6_Aligned.sortedByCoord.out,chr11,45172664,45181671,-,10,2,12,known,chr11:45172664-45181671
sample_6_Aligned.sortedByCoord.out,chr8,21768926,21777237,-,12,1,13,known,chr8:21768926-21777237
sample_6_Aligned.sortedByCoord.out,chr3,11687097,11689443,-,13,3,16,known,chr3:11687097-11689443
sample_6_Aligned.sortedByCoord.out,chr16,14485811,14493979,-,5,1,6,known,chr16:14485811-14493979
sample_6_Aligned.sortedByCoord.out,chr4,43322009,43325532,-,13,0,13,known,chr4:43322009-43325532
sample_6_Aligned.sortedByCoord.out,chr16,12915177,12924042,-,10,2,12,known,chr16:12915177-12924042
sample_6_Aligned.sortedByCoord.out,chr19,37620567,37626305,+,11,5,16,known,chr19:37620567-37626305
sample_6_Aligned.sortedByCoord.out,chr3,15571065,15578921,+,13,0,13,known,chr3:15571065-15578921
sample_6_Aligned.sortedByCoord.out,chr15,48513389,48519361,+,6,3,9,novel,chr15:48513389-48519361
sample_6_Aligned.sortedByCoord.out,chr16,25127018,25132034,+,6,0,6,known,chr16:25127018-25132034
sample_6_Aligned.sortedByCoord.out,chr1,45718435,45720830,+,12,4,16,known,chr1:45718435-45720830
sample_6_Aligned.sortedByCoord.out,chr3,11004599,11006209,-,14,3,17,known,chr3:11004599-11006209
sample_6_Aligned.sortedByCoord.out,chr12,23568650,23576473,-,12,0,12,novel,chr12:23568650-23576473
sample_6_Aligned.sortedByCoord.out,chr20,45526167,45530586,-,12,1,13,novel,chr20:45526167-45530586
sample_6_Aligned.sortedByCoord.out,chr9,20287413,20292286,-,9,4,13,known,chr9:20287413-20292286
sample_6_Aligned.sortedByCoord.out,chr22,32079305,32088409,-,10,1,11,known,chr22:32079305-32088409
sample_6_Aligned.sortedByCoord.out,chr15,32263955,32265768,-,11,0,11,known,chr15:32263955-32265768
sample_6_Aligned.sortedByCoord.out,chr3,41382150,41383770,-,10,2,12,known,chr3:41382150-41383770
sample_6_Aligned.sortedByCoord.out,chr15,48947406,48954428,+,10,1,11,known,chr15:48947406-48954428
sample_6_Aligned.sortedByCoord.out,chr13,24649118,24652452,-,9,2,11,known,chr13:24649118-24652452
sample_6_Aligned.sortedByCoord.out,chr19,1300385,1306217,+,14,0,14,known,chr19:1300385-1306217
sample_6_Aligned.sortedByCoord.out,chr11,13333002,13337506,+,10,1,11,known,chr11:13333002-13337506
sample_6_Aligned.sortedByCoord.out,chr19,20975274,20976047,+,7,0,7,known,chr19:20975274-20976047
sample_6_Aligned.sortedByCoord.out,chr1,7487330,7495183,-,9,4,13,novel,chr1:7487330-7495183
sample_6_Aligned.sortedByCoord.out,chr11,22894891,22903432,-,8,0,8,known,chr11:22894891-22903432
sample_6_Aligned.sortedByCoord.out,chr22,26312740,26315229,+,7,4,11,novel,chr22:26312740-26315229
sample_6_Aligned.sortedByCoord.out,chr17,36150418,36156715,-,7,2,9,novel,chr17:36150418-36156715
sample_6_Aligned.sortedByCoord.out,chr4,14519819,14526047,-,7,2,9,known,chr4:14519819-14526047
sample_6_Aligned.sortedByCoord.out,chr21,12083717,12088025,-,6,6,12,known,chr21:12083717-12088025
sample_6_Aligned.sortedByCoord.out,chr16,43652630,43655602,-,13,3,16,known,chr16:43652630-43655602
sample_6_Aligned.sortedByCoord.out,chr18,33474828,33484374,+,8,2,10,known,chr18:33474828-33484374
sample_6_Aligned.sortedByCoord.out,chr11,34918202,34919090,-,13,0,13,novel,chr11:34918202-34919090
sample_6_Aligned.sortedByCoord.out,chr22,27678891,27685939,-,17,3,20,known,chr22:27678891-27685939
sample_6_Aligned.sortedByCoord.out,chr8,37067390,37073564,-,11,4,15,known,chr8:37067390-37073564
sample_6_Aligned.sortedByCoord.out,chr15,43028659,43034822,-,13,1,14,known,chr15:43028659-43034822
sample_6_Aligned.sortedByCoord.out,chr19,34190286,34198752,-,11,6,17,known,chr19:34190286-34198752
sample_6_Aligned.sortedByCoord.out,chr8,21492662,21499949,-,11,4,15,known,chr8:21492662-21499949
sample_6_Aligned.sortedByCoord.out,chr12,20332598,20333317,+,7,2,9,known,chr12:20332598-20333317
sample_6_Aligned.sortedByCoord.out,chr14,19948216,19956177,+,11,1,12,novel,chr14:19948216-19956177
sample_6_Aligned.sortedByCoord.out,chr12,24117278,24124987,-,11,6,17,novel,chr12:24117278-24124987
sample_6_Aligned.sortedByCoord.out,chr11,11802398,11805460,+,15,0,15,known,chr11:11802398-11805460
sample_6_Aligned.sortedByCoord.out,chr12,8662946,8668377,-,7,3,10,known,chr12:8662946-8668377
sample_6_Aligned.sortedByCoord.out,chr10,12542103,12544302,+,10,0,10,known,chr10:12542103-12544302
sample_6_Aligned.sortedByCoord.out,chr2,41644843,41652090,-,6,3,9,known,chr2:41644843-41652090
sample_6_Aligned.sortedByCoord.out,chr17,11412178,11416862,+,6,1,7,known,chr17:11412178-11416862
sample_6_Aligned.sortedByCoord.out,chr2,43949006,43958156,-,9,2,11,known,chr2:43949006-43958156
sample_6_Aligned.sortedByCoord.out,chr9,30143607,30147302,-,14,1,15,known,chr9:30143607-30147302
sample_6_Aligned.sortedByCoord.out,chr16,5947077,5956482,-,6,3,9,known,chr16:5947077-5956482
sample_6_Aligned.sortedByCoord.out,chr14,49256488,49259369,+,9,4,13,known,chr14:49256488-49259369
sample_6_Aligned.sortedByCoord.out,chr9,22021074,22024576,+,7,3,10,known,chr9:22021074-22024576
sample_6_Aligned.sortedByCoord.out,chr8,6181128,6182214,+,6,0,6,known,chr8:6181128-6182214
sample_6_Aligned.sortedByCoord.out,chr14,35372209,35373071,+,7,2,9,novel,chr14:35372209-35373071
sample_6_Aligned.sortedByCoord.out,chr2,31541911,31543478,+,7,2,9,known,chr2:31541911-31543478
sample_6_Aligned.sortedByCoord.out,chr8,46509559,46512255,-,9,1,10,known,chr8:46509559-46512255
sample_6_Aligned.sortedByCoord.out,chr20,17891398,17899081,+,11,3,14,novel,chr20:17891398-17899081
sample_6_Aligned.sortedByCoord.out,chr19,16554479,16557421,+,7,0,7,novel,chr19:16554479-16557421
sample_6_Aligned.sortedByCoord.out,chr20,44985170,44993351,-,9,3,12,known,chr20:44985170-44993351
sample_6_Aligned.sortedByCoord.out,chr3,23347170,23349179,-,9,1,10,known,chr3:23347170-23349179
sample_6_Aligned.sortedByCoord.out,chr19,11194078,11203185,-,8,3,11,known,chr19:11194078-11203185
sample_6_Aligned.sortedByCoord.out,chr7,9807597,9816348,+,6,2,8,novel,chr7:9807597-9816348
sample_6_Aligned.sortedByCoord.out,chr7,3916703,3923295,-,11,1,12,known,chr7:3916703-3923295
sample_6_Aligned.sortedByCoord.out,chr18,32236925,32242705,-,15,1,16,known,chr18:32236925-32242705
sample_6_Aligned.sortedByCoord.out,chr1,45037870,45038344,+,10,1,11,novel,chr1:45037870-45038344
sample_6_Aligned.sortedByCoord.out,chr16,7260143,7262079,-,14,2,16,known,chr16:7260143-7262079
sample_6_Aligned.sortedByCoord.out,chr8,48603823,48611070,+,8,3,11,known,chr8:48603823-48611070
sample_6_Aligned.sortedByCoord.out,chr17,49527616,49528788,-,14,3,17,known,chr17:49527616-49528788
sample_6_Aligned.sortedByCoord.out,chr19,13994963,14000216,-,9,0,9,known,chr19:13994963-14000216
sample_6_Aligned.sortedByCoord.out,chr8,39137783,39145631,-,11,3,14,known,chr8:39137783-39145631
sample_6_Aligned.sortedByCoord.out,chr10,47247173,47254478,-,9,1,10,known,chr10:47247173-47254478
sample_6_Aligned.sortedByCoord.out,chr19,14966405,14971816,-,12,5,17,known,chr19:14966405-14971816
sample_6_Aligned.sortedByCoord.out,chr3,9877053,9884334,-,6,3,9,novel,chr3:9877053-9884334
sample_6_Aligned.sortedByCoord.out,chr20,48684485,48691300,+,7,4,11,novel,chr20:48684485-48691300
sample_6_Aligned.sortedByCoord.out,chr2,38297973,38306627,+,10,0,10,known,chr2:38297973-38306627
sample_6_Aligned.sortedByCoord.out,chr19,27635563,27636214,-,9,3,12,known,chr19:27635563-27636214
sample_6_Aligned.sortedByCoord.out,chr19,2996473,2998107,+,9,2,11,known,chr19:2996473-2998107
sample_6_Aligned.sortedByCoord.out,chr22,41678311,41683549,-,8,0,8,known,chr22:41678311-41683549
sample_6_Aligned.sortedByCoord.out,chr1,41309880,41318278,-,13,3,16,known,chr1:41309880-41318278
sample_6_Aligned.sortedByCoord.out,chr19,9205488,9206330,+,2,4,6,known,chr19:9205488-9206330
sample_6_Aligned.sortedByCoord.out,chr21,11294583,11300738,-,14,1,15,known,chr21:11294583-11300738
sample_6_Aligned.sortedByCoord.out,chr1,18613198,18616183,+,8,0,8,known,chr1:18613198-18616183
sample_6_Aligned.sortedByCoord.out,chr18,19955350,19958869,+,6,2,8,known,chr18:19955350-19958869
sample_6_Aligned.sortedByCoord.out,chr3,15416195,15424222,-,9,4,13,known,chr3:15416195-15424222
sample_6_Aligned.sortedByCoord.out,chr18,13478194,13484147,-,6,4,10,known,chr18:13478194-13484147
sample_6_Aligned.sortedByCoord.out,chr4,35628719,35629740,-,11,0,11,known,chr4:35628719-35629740
sample_6_Aligned.sortedByCoord.out,chr4,4664673,4665915,-,10,1,11,known,chr4:4664673-4665915
sample_6_Aligned.sortedByCoord.out,chr9,29837030,29838441,+,7,2,9,novel,chr9:29837030-29838441
sample_6_Aligned.sortedByCoord.out,chr12,34039477,34048261,+,8,6,14,known,chr12:34039477-34048261
sample_6_Aligned.sortedByCoord.out,chr7,41930418,41934363,-,9,2,11,known,chr7:41930418-41934363
sample_6_Aligned.sortedByCoord.out,chr17,17575444,17581983,+,3,1,4,known,chr17:17575444-17581983
sample_6_Aligned.sortedByCoord.out,chr15,45174676,45176694,-,6,2,8,known,chr15:45174676-45176694
sample_6_Aligned.sortedByCoord.out,chr17,44616786,44620713,+,15,2,17,novel,chr17:44616786-44620713
sample_6_Aligned.sortedByCoord.out,chr21,23868387,23878363,+,10,4,14,novel,chr21:23868387-23878363
sample_6_Aligned.sortedByCoord.out,chr21,24918716,24922524,-,15,2,17,known,chr21:24918716-24922524
sample_6_Aligned.sortedByCoord.out,chr19,49188228,49192537,-,11,1,12,known,chr19:49188228-49192537
sample_6_Aligned.sortedByCoord.out,chr2,24284481,24284933,-,4,6,10,known,chr2:24284481-24284933
sample_6_Aligned.sortedByCoord.out,chr16,20885518,20889385,+,11,1,12,known,chr16:20885518-20889385
sample_6_Aligned.sortedByCoord.out,chr8,20381594,20391285,+,11,0,11,known,chr8:20381594-20391285
sample_6_Aligned.sortedByCoord.out,chr9,20299485,20300868,+,10,3,13,novel,chr9:20299485-20300868
sample_6_Aligned.sortedByCoord.out,chr8,12444643,12445128,+,8,1,9,novel,chr8:12444643-12445128
sample_6_Aligned.sortedByCoord.out,chr14,42332888,42341939,-,12,4,16,known,chr14:42332888-42341939
sample_6_Aligned.sortedByCoord.out,chr3,24950476,24951934,+,15,3,18,known,chr3:24950476-24951934
sample_6_Aligned.sortedByCoord.out,chr22,24474022,24474262,+,13,0,13,novel,chr22:24474022-24474262
sample_6_Aligned.sortedByCoord.out,chr5,41525515,41530783,+,11,0,11,known,chr5:41525515-41530783
sample_6_Aligned.sortedByCoord.out,chr16,28701366,28702330,-,6,3,9,known,chr16:28701366-28702330
sample_6_Aligned.sortedByCoord.out,chr20,47041563,47042537,-,8,0,8,known,chr20:47041563-47042537
sample_6_Aligned.sortedByCoord.out,chr18,38021862,38028856,-,7,2,9,known,chr18:38021862-38028856
sample_6_Aligned.sortedByCoord.out,chr7,32034607,32044334,+,13,1,14,known,chr7:32034607-32044334
sample_6_Aligned.sortedByCoord.out,chr14,16275016,16275268,+,10,3,13,known,chr14:16275016-16275268
sample_6_Aligned.sortedByCoord.out,chr8,10844503,10849635,+,6,4,10,novel,chr8:10844503-10849635
sample_6_Aligned.sortedByCoord.out,chr12,44100786,44107618,+,12,0,12,known,chr12:44100786-44107618
sample_6_Aligned.sortedByCoord.out,chr18,29686163,29691535,+,11,2,13,known,chr18:29686163-29691535
sample_6_Aligned.sortedByCoord.out,chr18,15027419,15034787,+,11,4,15,known,chr18:15027419-15034787
sample_6_Aligned.sortedByCoord.out,chr5,19093963,19096425,+,11,3,14,known,chr5:19093963-19096425
sample_6_Aligned.sortedByCoord.out,chr15,14611308,14620824,-,9,0,9,known,chr15:14611308-14620824
sample_6_Aligned.sortedByCoord.out,chr19,39204075,39205580,-,6,0,6,known,chr19:39204075-39205580
sample_6_Aligned.sortedByCoord.out,chr11,39279040,39286566,-,12,3,15,known,chr11:39279040-39286566
sample_6_Aligned.sortedByCoord.out,chr3,13860042,13863069,+,12,1,13,known,chr3:13860042-13863069
sample_6_Aligned.sortedByCoord.out,chr6,43689890,43691861,+,16,0,16,known,chr6:43689890-43691861
sample_6_Aligned.sortedByCoord.out,chr1,1674589,1682782,+,10,1,11,known,chr1:1674589-1682782
sample_6_Aligned.sortedByCoord.out,chr10,6465259,6475238,-,9,1,10,known,chr10:6465259-6475238
sample_6_Aligned.sortedByCoord.out,chr12,16674496,16684217,-,11,5,16,known,chr12:16674496-16684217
sample_6_Aligned.sortedByCoord.out,chr1,40025004,40027644,-,7,0,7,known,chr1:40025004-40027644
sample_6_Aligned.sortedByCoord.out,chr1,22199840,22201295,-,15,1,16,novel,chr1:22199840-22201295
sample_6_Aligned.sortedByCoord.out,chr22,16721327,16727963,-,7,2,9,novel,chr22:16721327-16727963
sample_6_Aligned.sortedByCoord.out,chr20,45463840,45473558,-,10,1,11,known,chr20:45463840-45473558
sample_6_Aligned.sortedByCoord.out,chr17,3830003,3833403,-,5,3,8,novel,chr17:3830003-3833403
sample_6_Aligned.sortedByCoord.out,chr3,42551593,42554126,+,12,3,15,known,chr3:42551593-42554126
sample_6_Aligned.sortedByCoord.out,chr14,13042458,13049949,+,6,0,6,novel,chr14:13042458-13049949
sample_6_Aligned.sortedByCoord.out,chr6,47399061,47407097,+,10,6,16,known,chr6:47399061-47407097
sample_6_Aligned.sortedByCoord.out,chr13,47420069,47427527,-,11,1,12,known,chr13:47420069-47427527
sample_6_Aligned.sortedByCoord.out,chr14,6291334,6300154,-,7,2,9,known,chr14:6291334-6300154
sample_6_Aligned.sortedByCoord.out,chr7,29810314,29817512,-,8,5,13,known,chr7:29810314-29817512
sample_6_Aligned.sortedByCoord.out,chr3,42316344,42326209,+,11,1,12,known,chr3:42316344-42326209
sample_6_Aligned.sortedByCoord.out,chr19,29260666,29269721,-,11,2,13,novel,chr19:29260666-29269721
sample_6_Aligned.sortedByCoord.out,chr10,17390164,17399085,-,4,4,8,known,chr10:17390164-17399085
